31
31
PPPPPPPPPPPPPPPPPPPPPPPPPPPPPPP
PPPPPPPPPPPPPPPPPPPPPPPPPPPPPPP
PPPPPPPPPPPPPPPPPPPPPPPPPPPPPPP
PPPAAAAAAAAAAAADAAAAAAAAAAAAPPP
PPPAAAAAAAAAAAAAAAAAAAAAAAAAPPP
PPPASSSSSCCCCCCCCCCCCCCCCCCAPPP
PPPSSSSSSCSSSSSPPPPPPPPPPPXXPPP
PPPSSSSSSCSSSSSPXXXXXXXXXXXXPPP
PPPSSSSSSCSSSSSPXXXXXXXXXXXXPPP
PPPSSSSSSCSSSSSPXXPPPPPPPPPPPPP
PPPSSSSSSCSSSSSPXXXXXXXXXXXXPPP
PPPSSSSSSCSSSSSPXXXXXXXXXXXXPPP
PPPSSSSSSCSSSSSPPPPPPPPPPPXXPPP
PPPSSSSSSCSSSSSPXXXXXXXXXXXXPPP
PPPSSSSSSCSSSSSPXXXXXXXXXXXXPPP
PPPSSSSSSCSSSSSPBBPPPPPPPPPPPPP
PPPSSSSSSCSSSSSPXXXXXXXXXXXXPPP
PPPSSSSSSCSSSSSPXXXXXXXXXXXXPPP
PPPSSSSSSCSSSSSPPPPPPPPPPPXXPPP
PPPSSSSSSCSSSSSPXXXXXXXXXXXXPPP
PPPSSSSSSCSSSSSPXXXXXXXXXXXXPPP
PPPSSSSSSCSSSSSPXXPPPPPPPPPPPPP
PPPSSSSSSCSSSSSPXXXXXXXXXXXXPPP
PPPSSSSSSCSSSSSPXXXXXXXXXXXXPPP
PPPSSSSSSCSSSSSPPPPPPPPPPPXXPPP
PPPBSSSSSCCCCCCCCCCCCCCCCCCBPPP
PPPBBBBBBBBBBBBBBBBBBBBBBBBBPPP
PPPBBBBBBBBBBBBBBBBBBBBBBBBBPPP
PPPPPPPPPPPPPPPPPPPPPPPPPPPPPPP
PPPPPPPPPPPPPPPPPPPPPPPPPPPPPPP
PPPPPPPPPPPPPPPPPPPPPPPPPPPPPPP
0000000000000000000000000000000
0000000000000000000000000000000
0000000000000000000000000000000
0001111111111111111111111111000
0001111111111111111111111111000
0001222222222222222222222221000
0002222222222220000000000033000
0002222222222220333333333333000
0002222222222220333333333333000
0002222222222220330000000000000
0002222222222220333333333333000
0002222222222220333333333333000
0002222222222220000000000033000
0002222222222220333333333333000
0002222222222220333333333333000
0004444444444440440000000000000
0002222222222220333333333333000
0002222222222220333333333333000
0002222222222220000000000033000
0002222222222220333333333333000
0002222222222220333333333333000
0002222222222220330000000000000
0002222222222220333333333333000
0002222222222220333333333333000
0002222222222220000000000033000
0001222222222222222222222221000
0001111111111111111111111111000
0001111111111111111111111111000
0000000000000000000000000000000
0000000000000000000000000000000
0000000000000000000000000000000
