30
30
PPPPPPPPPPPPPPPPPPPPPPPPPPPPPP
PPPPPPPPPPPPPPPPPPPPPPPPPPPPPP
PPPPPPPPPPPPPPPPPPPPPPPPPPPPPP
PPPTTTTTTCCCCCTTTTTTTCCCCCTPPP
PPPTTTTTTCTCTTTTTTTCCCTTTTPPPP
PPPTTTTTTCTCCCCCCCCCTCTTTTPPPP
PPPTTTTTTCCCCCTTTTTTTCCCCCTPPP
PPPTTTTTTTTTTCTTTTTTTTCTTTPPPP
PPPTTTTTTTTTTCTTTTTTTTCTTTPPPP
PPPTTTTTTTTTTCTTTTTTTTCTTTPPPP
PPPTTTTTTCCCCCTTTTTTCCCCCTPPPP
PPPTTTTTTCTCTTTTTTTCTCTTTTPPPP
PPPTTTTTTCTCTTTTTTTCTCTTTTPPPP
PPPTTTTTTCCCCCTTTTTTTCCCCCTPPP
PPPTTTTTTSSCSSTTTTTTTSCSSSTPPP
PPPTTTTTTSSCSSTTTTTTTSCSSSTPPP
PPPTTTTTTSSCSSTTTTTTTSCSSSTPPP
PPPTTTTTTSSCSSTTTTTTTSCSSSTPPP
PPPTTTTTTSSCSSTTTTTTTSCSSSTPPP
PPPCTTTTTTCCCCCTTTTTTTTCCCCPPP
PPPCCCCCCCCTCTTTTTTTTTCTTTCPPP
PPPCTTTTTTCTCTTTTTTTTTCTTXCPPP
PPPCXTTTTTCCCCCTTTTTTTTCCCCPPP
PPPAAAAAATTTTTTTTTTTTTTTTAAAAA
PPPAAAAAATTTTTTTTTTTTTTTTAAAAA
PPPAAAAAATTTTTTTTTTTTTTTTAAAAA
PPPPPPPPPPPPPPPPPPPPPPPPPPPPPP
PPPPPPPPPPPPPPPPPPPPPPPPPPPPPP
PPPPPPPPPPPPPPPPPPPPPPPPPPPPPP
000000000000000000000000000000
000000000000000000000000000000
000000000000000000000000000000
000222222211111122222111111000
000222222212111122222121111000
000222222212111122222121111000
000222222211111122222111111000
000222222222222222222222222000
000222222222222222222222222000
000222222222222222222222222000
000222222211111122222111111000
000222222212111122222121111000
000222222212111122222121111000
000222222211111122222111111000
000222222223232222222323222000
000222222223232222222323222000
000222222223232222222323222000
000222222223232222222323222000
000222222223232222222323222000
000222222223232222222323222000
000222222223232222222323222000
000222222223232222222323222000
000222222223232222222323222000
000222222211111122222111111000
000222222212111122222121111000
000222222212111122222121111000
000222222211111122222111111000
000000000000000000000000000000
000000000000000000000000000000
000000000000000000000000000000