100
100
PPPPPPPPPPPPPPPPPPPPPPPPPPPPPPPPPPPPPPPPPPPPPPPPPPPPPPPPPPPPPPPPPPPPPPPPPPPPPPPPPPPPPPPPPPPPPPPPPPPP
PPPPPPPPPPPPPPPPPPPPPPPPPPPPPPPPPPPPPPPPPPPPPPPPPPPPPPPPPPPPPPPPPPPPPPPPPPPPPPPPPPPPPPPPPPPPPPPPPPPP
PPPPPPPPPPPPPPPPPPPPPPPPPPPPPPPPPPPPPPPPPPPPPPPPPPPPPPPPPPPPPPPPPPPPPPPPPPPPPPPPPPPPPPPPPPPPPPPPPPPP
PPPTTTXXTTTXXTTTTTTTTTTTTTXXTTTTTTTTTTTTTTTTTTTTTTTTTTTTTTTTTTXXTTTTAATTTTTTTTTTTTTTTTTTTTXXTTTTTPPP
PPPTTTCCTTTTCCTTTTTTTTTTTTCCTTTTTTTTTTTTTTTTTTTTTTTTTTTTTTTTTTTCCTTAATTTTTTTTTTTTTTTTTTTTCCTTTTTTPPP
PPPTTTTCCTTCCTTTTTTTTTTTTTTCCTTTTTTTTTTTTTTTTTTTTTTTTTTTTTTTTTBCCBBAABBBTTTTTTTTTTTTTTTTTCCTTTTTDPPP
PPPTTTTCCTCCTTTTTTTTTTTTTTTCCTTTTTTTTTTTTTTTTTTTTTTTTTTTTTTTTTCCCCBBAABBTTTTTTTTTTTTTTTTTCCTTTTTTPPP
PPPTTTTCCTTCCTTTTTTTTTTTTTTTCCTTTTTTTTTTTTTTTTTTTTTTTTTTTTTTTTBCCBBAABBBTTTTTTTTTTTTTTTTTCCTTTTTTPPP
PPPCTTCCTTTCCTTTTTTTTTTTTTTTCCTTTTTTTTTTTTTTTTTTTTTTTTTTTTTTTTCCBBAABBBBTTTTTTTTTTTTTTTTTTCCTTTTTPPP
PPPCCTTCCTCCCCCCTTTTTTTTTTTTTCCTTTTTTTTTTTTTTTTTTTTTTTTTTTTBBBBCCAABBBBCCCCCCCCCCCCCCTTTTTTCCTTTTPPP
PPPTCCCCCCCCCCCCCCTCTCTTTTTTTTCCTTTTTTTTTTTTTTTTTTTTTTTTTTTBBBBBCCBBBBBCSSSSSSSSSSSSCTTTTTTCCTTTTPPP
PPPTTCCTTCCCTTTTCCCCCCCCCTTTTTCCTTTTTTTTTTTTTTTTTTTTTTTTTTTBBBBCCAABBBBCSSSSSSSSSSSSCBBTTTTCCTTTTPPP
PPPTTTCCTTTCCTTTTTCTCTCCCCCTTCCTCTTTTTTTTTTTTCCTTTTTTTTTTTTBBBBBCCBBBBBCSSSSSSSSSSSSCBBTTTTCCTTTTPPP
PPPTTTCCTTCCTTTTTTTTTTTTTCCCTTCCCCTTTTTCTTTTCCCCDTTTTTTTTTTBBBBCCBBBBBBCSSSSSSSSSSSSCBBTTTTCCTTTTPPP
PPPTTCCTTCCTTTTTTTTTTTTTTTTCCCCCTCCTTTCCCCTCCTTCCCTTTTTTTTTBBBBBCCBBBBBCSSSSSSSSSSSSCBBTTTCCTTTTTPPP
PPPTTCCTCCTTTTTTTTTTTTTTTTTTCCTTTTCCTCCTCCCCTTTTCCCCCTCTTTTBBBBCCCCBBBBCSSSSSSSSSSSSCBBTTTTCCTTTTPPP
PPPTTTCCCCTTTTTTTTTTTTTTTCCCCCCCCCCCCCCTTTCTTTTTTTCCCCCCTTTBBBBCCCCBBBBCSSSSSSSSSSSSCBBTTTCCTTTTTPPP
PPPTTTTCCTTTTTTTTTTTTTTTTCCCCCCCCCCCCCCTTTTTTTTTTTTTTCTCCCTBBBBCCCCBBBBCSSSSSSSSSSSSCBBTTTTCCTTTTPPP
PPPTTTCCCCTTTTTTTTTTTTTTTCCCCCCCCCCCCCCTTTTTTTTTTTTTTTTTCCCBBBBBCCBBBBBCSSSSSSSSSSSSCBBTTTTCCTTTTPPP
PPPTTTTTCCTTTTTTTTTTTTTTTCCCCCCCCCCCCCCTTTTTTTTTTTTTTTTTTTCCBBBCCCBBBBBCSSSSSSSSSSSSCBBTTTTTCTCTTPPP
PPPTTTTCCCCTTTTTTTTTTTTTTCCCCCCCCCCCCCCTTTTTTTTTTTTTTTTTTTTCCBCCCCCBBBBCSSSSSSSSSSSSCBBTTTCCCCCCTPPP
PPPTTTCCCCTTTTTTTTTTTTTTTCCCCCCCCCCCCCCTTTTTTTTTTTTTTTTTTTTBCCCBCCCCCBBCSSSSSSSSSSSSCCCCCCCCTCTCCPPP
PPPTTTTCCCCTTTTTTTTTTTTTTCCCCCCCCCCCCCCTTTTTTTTTTTTTTTTTTTTBBCBBBCCCCCCCCCCCCCCCCCCCCCMMMMCTCCTTCPPP
PPPTTTTCCTCCTTTTTTTTTTTTTCCCCCCCCCCCCCCTTTTTTTTTTTTTTTTTTTTBBBBBAACCBCCCCCCCCCCCCCCCBCMCCCCCCCTCTPPP
PPPCCCCCCCCCCCCCCCCCTTTTTCCCCCCCCCCCCCCTTTTTTTTTTTTTTTTTTTTBBBBAABBCCCBCCCBBCCCCBBCCBCMCCCTCCCCCTPPP
PPPMMMMMMMMMMMMMMMMCTTTTTCCCCCCCCCCCCCCTTTTTTTTTTTTTTTTTTTTBBCCBAACCCCBBBBBBBBBBBBBBBCMCCCTTCCCTTPPP
PPPMCCCCCCCCCCCCCCMCTTTTTCCCCCCCCCCCCCCTTTTTTTTTTTTTTTTTTTTCCCCAACCBCBBBBBBBBBBBBBBBBCMCCCTTCCTTTPPP
PPPMCCCCCCCCCCCCCCMCTTTTTCCCCCCCCCCCCCCTTTTTTTTTTTTTTTTTCTCCCTTAATCCTTTTTTTTTTTTTTTTTCMCCCTTTCCTTPPP
PPPMCCCCCCCCCCCCCCCCCCCCCCCCCCCCCCCCCCCTTTTTTTTTTTTTTTTCCCCTTTAACCTCCTTTBBBBBBBBBBBBBCMCCCTTTTCCTPPP
PPPMCCCCCCCCCCCCCCMCCCCCCCCCCCCCCCCCCCCTTTTTTTTTTTTTTTCCTCTTTAATTCCCCTTTBBBBBBBBBBBBBCMCCCTTTTTCCPPP
PPPMCCCCCCCCCCCCCCMCCCCCCCCTTTTTTTTTTTTTTTTTTTTTTTTTTCCTTTTTTTAATTCCTTTTBBBBBBBBBBBBBCMCCCTTTTCCTPPP
PPPMCCCCCCCCCCCCCCMCCCCCCCTTTTTTTTTTTTTTTTTTTTTTTTCTCCTTTTTTTTAATCCCCTTTBBBBBBBBBBBBBCMCCCTTTTCCTPPP
PPPMCCCCCCCCCCCCCCMCCCCCCCBBBTTTTTTTTTTTTTTTTTTTTCCCCTTTTTTTTTTAATCCTTTTBBBBBBBBBBBBBCMCCCTTTTTCCPPP
PPPMCCCCCCCCCCCCCCMCCCCCCCCBBTTTTTTTTTTTTTTTTTCTCCTCTTTTTTTTTTAATCCTTTTTBBBBBBBBBBBBBCMCCCTTTTTCCPPP
PPPMCCCCCCCCCCCCCCMCCCCCCCCCCCCCCCCCCCCCCCCCTCCCCTTTTTTTTTTTTTAATCCTTTBBBBBBBBBBBBBBBCMCCCTTTTCCTPPP
PPPMCCCCCCCCCCCCCCMCCCCCMMMMMMMMMMMMMMMCCCCCCCTCTTTTTTTTTTTTTTAACCCCTTBBBBBBBBBBBBBBBCMCCCTTTTTCCPPP
PPPMCCCCCCCCCCCCCCMCCCCCMCCCCCCCCCCCCCCMCTTTCTTTTTTTTTTTTTTTTTTAATCCTTBBBBBBBBBBBBBBBCMCCCTTTTCCTPPP
PPPMCCCCCCCCCCCCCCMCCCCCMCCCCCCCCCCCCCCMCTTTTTTTTTTTTTTTTTTTTTTTAACCTTBBBBBBBBBBBBBBBCMMMMTTTCCTCPPP
PPPMCCCCCCCCCCCCCCMCCCCCMCCCCCCCCCCCCCCMCTTTTTTTTTTTTTTTTTTTTTTAACCTTTBBBBBBBBCCBBBBBCCCCCTCCCCCCPPP
PPPMCCCCCCCCCCCCCCMCCCCCMCCCCCCCCCCCCCCMCTTTTTTTTTTTTTTTTTTTTTTTTCCTTTBBBBBBBCCCCBBBBBBBTTCCCCTCCPPP
PPPMMMMMMMMMMMMMMMMCCBBCMCCCCCCCCCCCCCCMCTTTTTTTTTTTTTTTTTTTCCTTAACCTTBBCBBBCCBBCCBBBBBBTCCTTTTTTPPP
PPPCCCCCCCCCCCCCCCCCCCBCMCCCCCCCCCCCCCCMCCTTTTTTTTTTTTTTTTCCCCCCTCCCTTBCCBCCCBBBBCCCCCBCCCTTTTTTTPPP
PPPTTTBBCCBCCBBBBBBBBCCCMCCCCCCCCCCCCCCMCCTTTTTTTTTTTTTTTCCCCTCCCCTCCTCCBCCCBBBBBBCCCCCCCCTTTTTTTPPP
PPPTTTBBBBCCBCBBBCBBBCCCMCCCCCCCCCCCCCCCCCCCCCCCCCCCCCCCCCTTCTTTCCCCCCCCCCCCCBBBBBBBBBCBCCTTTTTTTPPP
PPPCTTBBBBCCCCCBCCCBCCBCMCCCCCCCCCCCCCCCMMMMMMMMMMMMMMMMCTTTTTTTTCCTTCCCCBCCCCCCBBBBBBTTCCTTTTTTTPPP
PPPCCTTTTCCCCBCCCBCCCBBCMCCCCCCCCCCCCCCCMCCCCCCCCCCCCCCMCTTTTTTTTCCTTTCBBBBBBCCCCBBBBBTTCCTTTTTTTPPP
PPPTCCCTCCCCBBBCBBBCBBBCCCCCCCCCCCCCCCCCMCCCCCCCCCCCCCCMCTTTTTTTTCCTTTBBBBBBBBBBCCBBBBTTCCTTTTTTTPPP
PPPTTCCCCTCCBBBBBBBBBBBCMCCCCCCCCCCCCCCCMCCCCCCCCCCCCCCCCTTTTTTTTCCTTTBBBBBBBBBBBCCCCBTTCCTTTTTTTPPP
PPPTTTTCTCCBBBBBBBBBBBBCMCCCCCCCCCCCCCCCMCCCCCCCCCCCCCCMCTTTTTTTCCTTTTBBBBBBBBBBBBCCCCTTCCTTTTCCTPPP
PPPTTTTTTCCBBBBBBBBBBBBCMCCCCCCCCCCCCCCCMCCCCCCCCCCCCCCMCTTTTTTTTCCTTTBBBBBBBBBBBBBBBCCTCCCCTCCCCPPP
PPPTTTTTCCBBBBBBBBBBBBBCMMMMMMMMMMMMMMMCCCCCCCCCCCCCCCCMCTTTTTTTTCCTTTTTTTTTTTTTTTTTTTCCCCCCCCTTCPPP
PPPTTTTCCCCBBBBBBBBBBBBCCCCCCCCCCCCCCCCCMCCCCCCXXCCCCCCMCTTTTTTTTTCCTTTTTTTTTTTTTTTTTTTCCCTTCTTTTPPP
PPPTTTCCCCBBBBBBBBBBBBBBCCBBBBBBBBBTTTTCMCCCCCCXXCCCCCCMCTTTTTTTTTCCTTTTTTTTTTTTTTTTTTTTCCTTTTTTTPPP
PPPTTTCCCCTTTTTTTTTBBBBCCBBBBBBBBBBTTTTCMCCCCCCCCCCCCCCMCTTTTTTTTCCTTTTTTTTTTTTTTTTTTTTTTTTTTTTTTPPP
PPPTTCCCCTTTTTTTTTTBBBCCBBBBBBBBBBBTTBBCMCCCCCCCCCCCCCCMCBBBBBBBCCTTTTTTTTTTTTTTTTTTTTTTTTTTTTTTTPPP
PPPTCCTTCCTTTTTTTTTBBBBCCCCCCCCCCCCCCCCCCCCCCCCCCCCCCCCMCBBBBBBCCAATTTTTTTTTTTTTTTTTTTTTTTTTTTTTTPPP
PPPTCCTTTCCTTTTTTTTBBBBCMMMMMMMMMMMMMMMMCCCCCCCCCCCCCCCMCBBBBBBBCCBBBBBBBBBBBBBBBBTTTTTTTTTTTTTTTPPP
PPPCCTTTTTCCTTTTTTTBBBBCCCCCCCCCCCCCCCCMCCCCCCCCCCCCCCCMCBBBBBBCCCCBBBBBBBBBBBBBBBTTTTTTTTTTTTTTTPPP
PPPTCCTTTCCTTTTTTTTBBBBCMCCCCCCCCCCCCCCMCCCCCCCCCCCCCCCMCBBBBBBBCCCCBBBBBBBBBBBBBBTTTTTTTTTTTTTTTPPP
PPPCCTTTCCTTTTTTTTTBBBBCMCCCCCCCCCCCCCCMCMMMMMMMMMMMMMMMCBBBBBBCCTBCCBBBBBBBBBBBBBTTTTTTTTTTTTTTTPPP
PPPCCTTTTCCTTTTTTTTBBBBCMCCCCCCCCCCCCCCMCCCCCCCCCCCCCCCCCBBBBDCCAABBCCBBBBBBBBBBBBTTTTTTTTTTTTTTTPPP
PPPCCTTTTTCCTTTTTTTBBBBCMCCCCCCCCCCCCCCMCBBBBBBBBBBBBBBBBBBBBBBCCAACCBBCCCCCCCCCCCCCCCCTTTTTTTTTTPPP
PPPTTTTTTTCCTTTTTTTBBBBCMCCCCCCCCCCCCCCMCBBBBBBBBBBBBBBBBBBBBBBBCCCCBBBCCCCCCCCCCCCCCCCTTTTTTTTTTPPP
PPPTTTTTTCCTTTTTTTTBBBBCMCCCCCCCCCCCCCCMCBBBBBBBBBBBBBBBBBBBBBBBBCCBBBBCCCCCCCCCCCCCCCCTTTTTTTTTTPPP
PPPTTTTTCCTTTTTTTTTBBBBCMCCCCCCCCCCCCCCMCBBBBBBBBBBBBBBBBBBBBBBBCCBBBBBCCCCCCCCCCCCCCCCTTTTTTTTTTPPP
PPPTTTTTCCTTTTTTTTTBBBBCMCCCCCCCCCCCCCCMCBBBBBBBBBBBBBBBBBBBBBBBBCCBBBBCCCCCCCCCCCCCCCCTTTTTTTTTTPPP
PPPTTTTTCCTTTTTTTTTBBBBCMCCCCCCCCCCCCCCMCBXBBBBBBBBBBBBBBBBBBBBBBTCCBBBCCCCCCCCCCCCCCCCTTTTTTTTTTPPP
PPPTTTTTTCCTTTTTTTTTTBBCMCCCCCCCCCCCCCCMCBBBBBBBBBBBBBBBBBBBBBBBBCCBBBBCCCCCCCCCCCCCCCCTTTTTTTTTTPPP
PPPTTTTTCCTTTTTTTTTTTBBCMCCCCCCCCCCCCCCCCBBBBBBBBBBBBBBBBBBBBBBBCCBBBBBCCCCCCCCCCCCCCCCTTTTTTTTTTPPP
PPPTTTTCCTTTTTTTTTTTTBBCMCCCCCCCCCCCCCCMCBBBBBBBBBBBBBBBBBBBBBBBBCCBBBBCCCCCCCCCCCCCCCCTTTTTTTTTTPPP
PPPTTTCCTTTTTTTTTTTTTBBCMCCCCCCCCCCCCCCMCTTTTTTTTTTTTTTTTTTTTTTTTTCCBBBCCCCCCCCCCCCCCCCTTTTTTTTTTPPP
PPPTTTTCCTTTTTTTTTTTTBBCMMMMMMMMMMMMMMMMCTTBBBBBBBBBBBBBBTTTTTTTTAACCBBCCCCCCCCCCCCCCCCTTTTTTTTTTPPP
PPPTTTTCCTTTTTTTTTTTTBBCCCCCCCCCCCCCCCCCCTTBBBBBBBBBBBBBBTTTTTTTTTAACCTCCCCCCCCCCCCCCCCTTTTTTTTTTPPP
PPPTTTTCCTTTTTTTTTTTTBCCBBBBBBBBBBBBBBBBTTTBBBBBBBBBBBBBBTTTTTTTTCCCCTTCCCCCCCCCCCCCCCCTTTTTTTTTTPPP
PPPTTTCCTTTTTTTTTTTTTBCCBBBBBBBBBBBBBBBBTTTBBBBBBBBBBBBBBTTTTTTTCCTCCTTCCCCCCCCCCCCCCCCCTTTTTTTTTPPP
PPPTTTCCTTTTTTTTTTTTTBBCCBBBBBBBBBBBBBBBTTTBBXBBBBBBBBBBBTTTTTTTTCCCCTTCCCCCCCCCCCCCCCCCCTTTTTTTTPPP
PPPTTTTCCTTTTTTTTTTTTTTTCCBBBBBBBBBBBBBBTTTBBBBBBBBBBBBBBTTDTTTTCCTCCTTCCCCCCCCCCCCCCCCTCCTTTTTTTPPP
PPPTTTCCTTTTTTTTTTTTTTTTCCBBBBBBBBBBBBBBTTTBBBBBBBBBBBBBBTTTTTTTCCAACCTTTTATATTTTTTCCTTTTCCTTTTTTPPP
PPPTTTCCATTTTTTTTTTTTTTCCBBBBBBBABAABBBBTTTBBBBBBBBBABBBBTTTTTTCCAATTCCTAAAAAAATATCCTTTTTTCTCTTCCPPP
PPPCTACCAATTTTAATTTTTTABCCBBBBBAAAAAABBBBBBBBBBBABBAAABABAATATTATTAAACCAAACATAAAAACATAATTCCCCCCCCPPP
PPPCCACCTAAAAAAAAATTTAAACCBBABAABABBAAABBBBBBBBAAAAABAAAAAAAACCATTTAACCACTCTTTTATAAAAAATCCCCACCCCPPP
PPPTCTCCCTAAAATTAATTAATAABAAAAABBBBBBAAAABBBABAABAACBCABATTACCCCCCCATCCCCCCTTTTTTTATATCCCTTTATTCCPPP
PPPTTCCTCCTTCTTTCCCCATTBAAAABABBBBBBBBBAAAAAAAACBCBCCCBBBTTCCTTCCCCCCTCCCCCCTTTTCCCTCCCCTTTTTTTTTPPP
PPPTTCCTCCCCCCTCCCCCCTCBBACCCBBBBCCCCBBBBAAACABCCCBCCBBCCTCCTTTCCTTCCCCTCTTCCCBCCCCCCCBBBBTTTTTTTPPP
PPPCCCCCCTCCTCCCTTTTCCCCCBCCCCBBCCCCCCBBBCCBCBBCCCCCCBCCCCCTTTCCTTTAACTTTTTTCCCCBBBCBBBBBBTTTTTTTPPP
PPPCCCCCTTTTTTCTTTTTTCTCCCCBBCCCCBCCCCBBCCCBCBCCBCCBCCCTTCTTTTTCCTTTTCCTTTTTTTCBBBBBBBBBBBTTTTTTTPPP
PPPTTTCCTTTTTTTTTTTTTTTBBCCCCCCCCCCCCCCCCCBCCCCBBBBBBCTTTTTTTTTCCTTTCCTTTTTTTTBBBBBBBBBBBBTTTTTTTPPP
PPPTTTTCCTTTTTTTTTTTTTTBBCCCCCBBCCBBBCCCCCCCBCBBBBBBBTTTTTTTTTCCTTTTCCTTTTTTTTBBBBBBBBBBBBTTTTTTTPPP
PPPTTTCCTTTTTTTTTTTTTTTBCCBBBBBBBBBBBBBBCBCBBBBBBBBBBTTTTTTTTTCCTTTTTCCTTTTTTTBBBBBBBBBBBBTTTTTTTPPP
PPPTTTTCCDTTTTTTTTTTTTTBBCCBBBBBBBBBBBBBBBBBBBBBBBBBBTTTTTTTTTCCTTTTCCTTTTTTTTBBBBBBBBBBBBTTTTTTTPPP
PPPTTTTTCCTTTTTTTTTTTTTTCCTTTTTTTTTTTTTTTTTTTTTDTTTTTTTTTTTTTCCTTTTCCTTTTTTTTTTTTTTTTTTTTTTTTTTTTPPP
PPPTTTTCCTTTTTTTTTTTTTTTCCTTTTTTTTTTTTTTTTTTTTTTTTTTTTTTTTTTTCCTTTTTCCTTTTTTTTTTTTTTTTTTTTTTTTTTTPPP
PPPTTTTTCCTTTTTTTTTTTTTTTCCTTTTTTTTTTTTTTTTTTTTTTTTTTTTTTTTTTCCTTTTTTCCTTTTTTTTTTTTTTTTTTTTTTTTTTPPP
PPPTTTTCCTTTTTTTTTTTTTTTTTCCTTTTTTTTTTTTTTTTTTTTTTTTTTTTTTTTCCTTTTTTCCTTTTTTTTTTTTTTTTTTTTTTTTTTTPPP
PPPTTTCCTTTTTTTTTTTTTTTTTTCCTTTTTTTTTTTTTTTTTTTTTTTTTTTTTTTCCTTTTTTTTCCTTTTTTTTTTTTTTTTTTTTTTTTTTPPP
PPPTTTTCCTTTTTTTTTTTTTTTTCCTTTTTTTTTTTTTTTTTTTTTTTTTTTTTTTTCCTTTTTTTAACCTTTTTTTTTTTTTTTTTDTTTTTTTPPP
PPPTTTTTXXTTTTTTTTTTTTTTTTXXTTTTTTTTTTTTTTTTTTTTTTTTTTTTTTTTXXTTTTTAAXXTTTTTTTTTTTTTTTTTTTTTTTTTTPPP
PPPPPPPPPPPPPPPPPPPPPPPPPPPPPPPPPPPPPPPPPPPPPPPPPPPPPPPPPPPPPPPPPPPPPPPPPPPPPPPPPPPPPPPPPPPPPPPPPPPP
PPPPPPPPPPPPPPPPPPPPPPPPPPPPPPPPPPPPPPPPPPPPPPPPPPPPPPPPPPPPPPPPPPPPPPPPPPPPPPPPPPPPPPPPPPPPPPPPPPPP
PPPPPPPPPPPPPPPPPPPPPPPPPPPPPPPPPPPPPPPPPPPPPPPPPPPPPPPPPPPPPPPPPPPPPPPPPPPPPPPPPPPPPPPPPPPPPPPPPPPP
0000000000000000000000000000000000000000000000000000000000000000000000000000000000000000000000000000
0000000000000000000000000000000000000000000000000000000000000000000000000000000000000000000000000000
0000000000000000000000000000000000000000000000000000000000000000000000000000000000000000000000000000
0002221122211222222222222211222222222222222222222222222222222211222211222222222222222222221122222000
0002221122221122222222222211222222222222222222222222222222222221122112222222222222222222211222222000
0002222112211222222222222221122222222222222222222222222222222221122112222222222222222222211222222000
0002222112112222222222222221122222222222222222222222222222222211112211222222222222222222211222222000
0002222112211222222222222222112222222222222222222222222222222221122112222222222222222222211222222000
0001221122211222222222222222112222222222222222222222222222222211221122222222222222222222221122222000
0001122112111111222222222222211222222222222222222222222222222221111222211111111111111222222112222000
0002111111111111112121222222221122222222222222222222222222222222112222211111111111111222222112222000
0002211221112222111111111222221122222222222222222222222222222221111222211111111111111222222112222000
0002221122211222221212111112211212222222222221122222222222222222112222211111111111111222222112222000
0002221122112222222222222111221111222221222211112222222222222221122222211111111111111222222112222000
0002211221122222222222222221111121122211112112211122222222222222112222211111111111111222221122222000
0002211211222222222222222222112222112112111122221111121222222221111222211111111111111222222112222000
0002221111222222222222222111111111111112221222222211111122222221111222211111111111111222221122222000
0002222112222222222222222111111111111112222222222222212111222221111222211111111111111222222112222000
0002221111222222222222222111111111111112222222222222222211122222112222211111111111111222222112222000
0002222211222222222222222111111111111112222222222222222222112221112222211111111111111222222212122000
0002222111122222222222222111111111111112222222222222222222211211111222211111111111111222221111112000
0002221111222222222222222111111111111112222222222222222222221112111112211111111111111111111121211000
0002222111122222222222222111111111111112222222222222222222222122211111111111111111111144441211221000
0002222112112222222222222111111111111112222222222222222222222222111121111111111111112141111111212000
0001111111111111111122222111111111111112222222222222222222222221122111211122111122112141112111112000
0004444444444444444122222111111111111112222222222222222222222112111111222222222222222141112211122000
0004111111111111114122222111111111111112222222222222222222211111111212222222222222222141112211222000
0004111111111111114122222111111111111112222222222222222212111221121122222222222222222141112221122000
0004111111111111111111111111111111111112222222222222222111122211112112222222222222222141112222112000
0004111111111111114111111111111111111112222222222222221121222112211112222222222222222141112222211000
0004111111111111114111111112222222222222222222222222211222222211221122222222222222222141112222112000
0004111111111111114111111122222222222222222222222212112222222211211112222222222222222141112222112000
0004111111111111114111111122222222222222222222222111122222222221121122222222222222222141112222211000
0004111111111111114111111112222222222222222222121121222222222211211222222222222222222141112222211000
0004111111111111114111111111111111111111111121111222222222222211211222222222222222222141112222112000
0004111111111111114111114444444444444441111111212222222222222211111122222222222222222141112222211000
0004111111111111114111114111111111111114122212222222222222222221121122222222222222222141112222112000
0004111111111111114111114111111111111114122222222222222222222222111122222222222222222144442221121000
0004111111111111114111114111111111111114122222222222222222222221111222222222221122222111112111111000
0004111111111111114111114111111111111114122222222222222222222222211222222222211112222222221111211000
0004444444444444444112214111111111111114122222222222222222221122111122221222112211222222211222222000
0001111111111111111111214111111111111114112222222222222222111111211122211211122221111121112222222000
0002222211211222222221114111111111111114112222222222222221111211112112112111222222111111112222222000
0002222222112122212221114111111111111111111111111111111111221222111111111111122222222212112222222000
0001222222111112111211214111111111111111444444444444444412222222211221111211111122222222112222222000
0001122221111211121112214111111111111111411111111111111412222222211222122222211112222222112222222000
0002111211112221222122211111111111111111411111111111111412222222211222222222222211222222112222222000
0002211112112222222222214111111111111111411111111111111112222222211222222222222221111222112222222000
0002222121122222222222214111111111111111411111111111111412222222112222222222222222111122112222112000
0002222221122222222222214111111111111111411111111111111412222222211222222222222222222112111121111000
0002222211222222222222214444444444444441111111111111111412222222211222222222222222222211111111221000
0002222111122222222222211111111111111111411111111111111412222222221122222222222222222221112212222000
0002221111222222222222221122222222222221411111111111111412222222221122222222222222222222112222222000
0002221111222222222222211222222222222221411111111111111412222222211222222222222222222222222222222000
0002211112222222222222112222222222222221411111111111111412222222112222222222222222222222222222222000
0002112211222222222222211111111111111111111111111111111412222221111222222222222222222222222222222000
0002112221122222222222214444444444444444111111111111111412222222112222222222222222222222222222222000
0001122222112222222222211111111111111114111111111111111412222221111222222222222222222222222222222000
0002112221122222222222214111111111111114111111111111111412222222111122222222222222222222222222222000
0001122211222222222222214111111111111114144444444444444412222221122112222222222222222222222222222000
0001122221122222222222214111111111111114111111111111111112222211112211222222222222222222222222222000
0001122222112222222222214111111111111114122222222222222222222221111112211111111111111112222222222000
0002222222112222222222214111111111111114122222222222222222222222111122211111111111111112222222222000
0002222221122222222222214111111111111114122222222222222222222222211222211111111111111112222222222000
0002222211222222222222214111111111111114122222222222222222222222112222211111111111111112222222222000
0002222211222222222222214111111111111114122222222222222222222222211222211111111111111112222222222000
0002222211222222222222214111111111111114121222222222222222222222221122211111111111111112222222222000
0002222221122222222222214111111111111114122222222222222222222222211222211111111111111112222222222000
0002222211222222222222214111111111111111122222222222222222222222112222211111111111111112222222222000
0002222112222222222222214111111111111114122222222222222222222222211222211111111111111112222222222000
0002221122222222222222214111111111111114122222222222222222222222221122211111111111111112222222222000
0002222112222222222222214444444444444444122222222222222222222222211112211111111111111112222222222000
0002222112222222222222211111111111111111122222222222222222222222221111211111111111111112222222222000
0002222112222222222222112222222222222222222222222222222222222222211112211111111111111112222222222000
0002221122222222222222112222222222222222222222222222222222222222112112211111111111111111222222222000
0002221122222222222222211222222222222222222221222222222222222222211112211111111111111111122222222000
0002222112222222222222221122222222222222222222222222222222222222112112211111111111111112112222222000
0002221122222222222222221122222222222222222222222222222222222222111111222212122222211222211222222000
0002221112222222222222211222222212112222222222222222122222222221111221121111111212112222221212211000
0001211111222211222222121122222111111222222222221221112121121221221111111111211111112112211111111000
0001111121111111112221111122121121221112222222211111211111111111222111111212222121111112111111111000
0002121112111122112211211211111222222111122212112111211212211111111121111112222222121211122212211000
0002211211221222111112221111212222222221111111112121112222211221111112111111222211121111222222222000
0002211211111121111112122111122221111222211111211121122112112221122111121221112111111122222222222000
0001111112112111222211111211112211111122211212211111121111122211222111222222111122212222222222222000
0001111122222212222221211112211112111122111212112112111221222221122221122222221222222222222222222000
0002221122222222222222222111111111111111112111122222212222222221122211222222222222222222222222222000
0002222112222222222222222111112211222111111121222222222222222211222211222222222222222222222222222000
0002221122222222222222221122222222222222121222222222222222222211222221122222222222222222222222222000
0002222112222222222222222112222222222222222222222222222222222211222211222222222222222222222222222000
0002222211222222222222221122222222222222222222222222222222222112222112222222222222222222222222222000
0002222112222222222222221122222222222222222222222222222222222112222211222222222222222222222222222000
0002222211222222222222222112222222222222222222222222222222222112222221122222222222222222222222222000
0002222112222222222222222211222222222222222222222222222222221122222211222222222222222222222222222000
0002221122222222222222222211222222222222222222222222222222211222222221122222222222222222222222222000
0002222112222222222222222112222222222222222222222222222222211222222211112222222222222222222222222000
0002222211222222222222222211222222222222222222222222222222221122222111122222222222222222222222222000
0000000000000000000000000000000000000000000000000000000000000000000000000000000000000000000000000000
0000000000000000000000000000000000000000000000000000000000000000000000000000000000000000000000000000
0000000000000000000000000000000000000000000000000000000000000000000000000000000000000000000000000000
