30
30
PPPPPPPPPPPPPPPPPPPPPPPPPPPPPP
PPPPPPPPPPPPPPPPPPPPPPPPPPPPPP
PPPPPPPPPPPPPPPPPPPPPPPPPPPPPP
PPPTXTTTBBBTTTAATTTSTTTTTSTPPP
PPPCCTTTBTTTTAATBTTSTBBTSSTPPP
PPPCTTTTTTTTTAATTTTSTTTSSTTPPP
PPPCTTTBTTTTTTAATBTSTTTSBTTPPP
PPPCTTTTTTTTTTAATTTSBBTSTTTPPP
PPPCCTTTBTBBTTAATBTSTTTSBTTPPP
PPPTCTTTTTTTTAATTTSSTTTSTTBPPP
PPPTCCCXTTTTTAATTTXTTTTSTTTPPP
PPPTCTTTTTTTTAATBTCTTSSSTTBPPP
PPPTCTTTTBTTTAATTCCTBSBSBTTPPP
PPPTCTTTBBBTTTAATCTTTSSSTTSPPP
PPPTCTTTBBBTTTAATCTTSSTTBSSPPP
PPPTCCTTTTTBTTBAACTTSTTTSSTPPP
PPPTTCTCCCCCCCCCTCTTSSSSSTTPPP
PPPBSCCCMMMMMMMCCCTSSSTTTTTPPP
PPPTSTTCMMBTTMMSTBTSTTTBBBTPPP
PPPTSTACMSSSSSSSTTTSSTBTTTTPPP
PPPTSATCMSMMMSSSTBTSSSTTTTTPPP
PPPTSTACMSSSSSSSTBTSBSTTTBTPPP
PPPTSTTCMMMMMMMSTTTSTSTTTTTPPP
PPPTSTTCMMMMMMMSTTSSBSSSTTTPPP
PPPTSTBCCCCCCCCCTBSSTTTSTTTPPP
PPPSSTTTTDTTBTTCCXSTSSTSTTTPPP
PPPSSSSSSSSSSSSSTBBBTSTSTBTPPP
PPPPPPPPPPPPPPPPPPPPPPPPPPPPPP
PPPPPPPPPPPPPPPPPPPPPPPPPPPPPP
PPPPPPPPPPPPPPPPPPPPPPPPPPPPPP
000000000000000000000000000000
000000000000000000000000000000
000000000000000000000000000000
000111111111111111111111111000
000111111111111111111111111000
000111111111111111111111111000
000111111333333333121111111000
000111111111444441131111111000
000111111131144411131111111000
000111111131145411131111111000
000111111131144411131111111000
000111111131444441231111111000
000111133333333332331111111000
000111111111111111111111111000
000111112222222222211111111000
000111112222222222211111111000
000111111111111111111111111000
000111112222222222222221111000
000111112222233333322221111000
000111112222234544322221111000
000111112222233333322221111000
000111112222222222222221111000
000111111111111111111111111000
000111111111111111111111111000
000111111111111111111111111000
000111111111111113111111111000
000111111111111111111111111000
000000000000000000000000000000
000000000000000000000000000000
000000000000000000000000000000


