30
30
PPPPPPPPPPPPPPPPPPPPPPPPPPPPPP
PPPPPPPPPPPPPPPPPPPPPPPPPPPPPP
PPPPPPPPPPPPPPPPPPPPPPPPPPPPPP
PPPSSCPPPXSSPPPSSSPPPSSSPPPPPP
PPPSSCCPPPCSSPPPSSSPPPSSSPPPPP
PPPSCSCCPPPCSSPPPSSSPPPSSSPPPP
PPPCSSSCCPPPCCSPPPSSSPPPSSSPPP
PPPSCSSSCCPPPCCSPPPSSSPPPSSPPP
PPPSSCSSSCCPPPCSSPPPSSSPPPSPPP
PPPSCSSSSSCCCCCSSSSSSSSSSSSPPP
PPPCSSSSSSSSCSSSSSSSSSSSSSSPPP
PPPSCSSSSSSCCSPPPSSSPPPSSSPPPP
PPPSSCPPPSSCPPPSSSPPPSSSPPPPPP
PPPSCSSPPPSCCPPPSSSPPPSSSPPPPP
PPPCSSSSSSSSCCCCCSSSSSSSSSSPPP
PPPSCSSSSSSSSSSSCCCCSSSSSSSPPP
PPPSSCSSSSPPPSSSPPPCSSPPPSSPPP
PPPSCSSSSSSPPPSSSPPPCSSPPPSPPP
PPPSCSSSSSSSPPPSSSPPPCSSPPPPPP
PPPCSSSSSSSSSPPPSSSPPPCSSPPPPP
PPPSCSSSSSSSSSPPPSSSPPPCSSPPPP
PPPSCSPPPSSSPPPSSSPPPSSCPPPPPP
PPPSSXSPPPSSSPPPSSSPPPSSCPPPPP
PPPSCSSSPPPSSSPPPSSSPPPSSCPPPP
PPPSCSSSSPPPSSSPPPSSSPPPCSXPPP
PPPCSSSSSSSSSSSSSSSSSSSCSSSPPP
PPPSCSSSSSSSSSSSSSSSSSCSSSSPPP
PPPPPPPPPPPPPPPPPPPPPPPPPPPPPP
PPPPPPPPPPPPPPPPPPPPPPPPPPPPPP
PPPPPPPPPPPPPPPPPPPPPPPPPPPPPP
000000000000000000000000000000
000000000000000000000000000000
000000000000000000000000000000
000000000000000000000000000000
000000000000000000000000000000
000000000000000000000000000000
000000000000000000000000000000
000000000000000000000000000000
000000000000000000000000000000
000000000000000000000000000000
000000000000000000000000000000
000000000000000000000000000000
000000000000000000000000000000
000000000000000000000000000000
000000000000000000000000000000
000000000000000000000000000000
000000000000000000000000000000
000000000000000000000000000000
000000000000000000000000000000
000000000000000000000000000000
000000000000000000000000000000
000000000000000000000000000000
000000000000000000000000000000
000000000000000000000000000000
000000000000000000000000000000
000000000000000000000000000000
000000000000000000000000000000
000000000000000000000000000000
000000000000000000000000000000
000000000000000000000000000000
