100
100
PPPPPPPPPPPPPPPPPPPPPPPPPPPPPPPPPPPPPPPPPPPPPPPPPPPPPPPPPPPPPPPPPPPPPPPPPPPPPPPPPPPPPPPPPPPPPPPPPPPP
PPPPPPPPPPPPPPPPPPPPPPPPPPPPPPPPPPPPPPPPPPPPPPPPPPPPPPPPPPPPPPPPPPPPPPPPPPPPPPPPPPPPPPPPPPPPPPPPPPPP
PPPPPPPPPPPPPPPPPPPPPPPPPPPPPPPPPPPPPPPPPPPPPPPPPPPPPPPPPPPPPPPPPPPPPPPPPPPPPPPPPPPPPPPPPPPPPPPPPPPP
PPPAAAAAAAAAAAAAAAAAAAAAAAAAAAAAAAAAAAAAAAAAAAAAAAAAAAAAAAAAAAAAAAAAAAAAAAAAAAAAAAAAAAMMMMMMMMMMMPPP
PPPAAAAAAAAAAAAAAAAAAAAAAAAAAAAAAAAAAAAAAAAAAAAAAAAAAAAAAAAAAAAAAAAAAAAAAAAAAAAAAAAAAMMMMMMMMMMMMPPP
PPPAAAAAAAAAAAAAAAAAAAAAAAAAAAAAAAAAAAAAAAAAAAAAAAAAAAAAAAAAAAAAAAAAAAAAAAAAAAAAAAAAMMMMMMMMMMMMMPPP
PPPAAAAAAAAAAAAAAAAAAAAAAAAAAAAAAAAAAAAAAAAAAAAAAAAAAAAAAAAAAAAAAAAAAAAAAAAAAAAAAAAAMMMMMMMMMMMMMPPP
PPPAAAAAAAAAAAAAAAAAAAAAAAAAAAAAAAAAAAAAAAAAAAAAAAAAAAAAAAAAAAAAAAAAAAAAAAAAAAAAAAAAMMMMMMMMMMMMMPPP
PPPAAAAAAAAAAAAAAAAAAAAAAAAAAAAAAAAAAAAAAAABCXCBAAAAAAAAAAAAAAAAAAAAAAAAAAAAAAAAAAAAMMMMMMMMMMMMMPPP
PPPAAAAAAAAAAAAAAAAAAAAAAAAAAAAAAAAAAAAATTABBCBBBAAAAASCAACAAAAAAAAAAAAAAAAAAAAAAAAMMMMMMMMMMMMMMPPP
PPPAAAAAAAAAAAAAAAAAAAATAAAAAAAAAAAAAATTTBTATATATBAACSSCSSCAAAASSSAAAAAAAAAAAAAAAAMMMMMMMMMMMMMMMPPP
PPPAAAAAAAAAAAAAAAAAATTTTAAAAAAAAAAACCCCBTBTATATACCCBCCCCCSSSSSSSSSBBAAAAAAAAAAAAAMMMMMMMMMMMMMMMPPP
PPPAAAAAAAAAAAAAAAAATTBTTTTTTTAAAAACCSSSSSSBTATACDDSSSSSSSCCCCSSSBBBAAAAAAAAAAAAAMMMMMMMMMMMMMMMMPPP
PPPAAAAAAAAAAAAAATTTTTTTTBTTTTTAACCSSSSSSSSSSBACDSSSSSSSSSSSSCCCAAAABTAAAAAAAAAAAMMMMMMMMMMMMMMMMPPP
PPPAAAAAAAAAAAAATTBTTTAATTTTTTSACCSSSSSSSSSSBTADSSSSSSSSSSSSSAAACBBBTAAAAAAAAAAAAMMMMMMMMMMMMMMMMPPP
PPPAAAAAAAAAAAAATTTTTSSSSSTTTSSSCSSSSSSSSSSBBAXCSSSSSSSSSSSCASSSCCBBTAAAAAAAAAAAAMMMMMMMMMMMMMMMMPPP
PPPAAAAAAAAAAAAATTBTTSSXCCCCCCCCCSSSSSSSAAAAACSCSSSSSSSSSSSCASSSSSCBTAAAAAAAAAAAAMMMMMMMMMMMMMMMMPPP
PPPAAAAAAAAAATTTTTTTTTTTTTTTSSSSSSSSSSAAACCCCSSSCACCCCSSSSSCASSSSSSCCAAAAAAAAAAAAMMMMMMMMMMMMMMMMPPP
PPPAAAAAAAAABBTTBTTTTTTTTTTTBBBBDDSSSSASACSSSSSSACSSSCSSSSSCASSSSSSBBCAAATSSTAAAAMMMMMMMMMMMMMMMMPPP
PPPAAAAAAABBBBTTTTTBTTTTTTTBBBBBBDDSSSAAACSSSSSSSSSSSCSSSSSCASSSSSSSSBCCAATTAAAAAAMMMMMMMMMMMMMMMPPP
PPPAAAAAAABTBBBBBTTTTTTTAATTTTBBBBDDSSASSCSSSSSSSSSSSCSSSSSCASSSSSSSSSBCCAAAAAAAAAAMMMMMMMMMMMMMMPPP
PPPAAAAAAABTTBBBBBAAAAAAAAAAAAAATBBBSSASSCSSSSSSSSSSSCSSSSSCASSSSSSSSSBBCAAAAAAATTAAMMMMMMMMMMMMMPPP
PPPAAAAAAABBTTBTBAAAATAAAATAAAAAAATBSSASSCSSASSAASSSSXCCSSSCASSSSSSSCCCCCAAAAAAAAAAAMMMMMMMMMMMMMPPP
PPPAAAAAAABBBBBBAAAAAAAAAAAAAAAAAAAASSASSXSAAAAAASSSSCCDCCCASSSSSSSCCSSSCCBBBSSSSSAAMMMMMMMMMMMMMPPP
PPPAAAAAAATTBBBBAAAAAAAATTAAAAAAAAAAAABBBSSSSSSASSSSSSSSSSCASSSSSSSCSSCCBBBBBBBBBBSAAMMMMMMMMMMMMPPP
PPPAAAAAAAABBTTAAAAAAAAADTTAAAAAATAAAABBSSSSSSSAASSSSSSSSSCSSSSSSSSCSCBBBBTTBBTBABBBBMMMMMMMMMMMMPPP
PPPAAAAAAAAABTBAATTAAAAADTTTTTAAAAAAAABBBSSSSSSASSSSSSSSSSCSSSSSSSSCSSCBBBBBBBTTAAABBMMMMMMMMMMMMPPP
PPPAAAAAAAAABTBAATTAAAAAAAATTTAAAAAAAAABBBSSBBASSSSSSSSSSSCSSSSSSSSCSSCBTBBBBBBBAABTTMMMMMMMMMMMMPPP
PPPAAAAAAAABBBBAAAAAAAAAAAAAAAAAAAAAAAAATTSBBABSSSSSSSSSSSCSSSSSSSSCSSCTTBBBTTBBTTTTMMMMMMMMMMMMMPPP
PPPAAAAAAABBTTBAAAAAAAAAAAAAAAAAAAAAAAAATTBBABBSSSSSSSSSSSCSSSSSSSSCSXBBBBTTTBBTTTBBMMMMMMMMMMMMMPPP
PPPAAAAAAACCBBBAAAAAAAAAAAATAAAAAAATAABATTBBATBBSSSSSSSSSXCSSSSSSSSCSCCBBTTTTBTTTTBBMMMMMMMMMMMMMPPP
PPPAAAAAAAACBBAAAAAAAAAAAATTAAAAAAATTTDAXDBABTBBSSSSSSSSSSSSSSSSSSCSSCCCBBTTTTTTTTTTMMMMMMMMMMMMMPPP
PPPAAAAAAAACCAAAAAAAAAAAAAATAAAAXTTTTTXADXBABTBSSSSSSSSSSSSSSSSSSSCSSCBBBBTTTTTTCXTTTMMMMMMMMMMMMPPP
PPPASAAAAAAACCAAAAAAAAAAAAAAAAACBBBBBBBAAAABTTBSSSSSSSSSSSSSSSSSSCSSSCCBBTTTTTTTCTTTBTTBBMMMMMMMMPPP
PPPAAAAAAAABBCATTTAAAAAAAAAACCCBBBBBBAAAXDBBTBSSSSSSSSSSSSSSSSSSSCSSSSCCBBTTTTTTCTTBBBBBBBMMMMMMMPPP
PPPAAATAAAABBCAAAAAAACCCCCCCCBBBBBAAAABBBBBTTBSSSSSSSSSSSSSSSSSSCSSBBSSCCCTTTTAXCTTBABTBBMMMMMMMMPPP
PPPAAATTAAABBCCAAAAACBBBBBBBBBBAAAABBBBBBBBSBSSSSSSSSSSSSSSSSSSCSSBBBBBBSCBTTTTTBTTBSTTBBMMMMMMMMPPP
PPPAAAAAAAABBBCDXDXCBBBBBBTBBBAABBBBBSBTTBBSSBSSSSSSSSSSSSSSCCCCBBBABBBSSCSSBBSSBBBBBTBBMMMMMMMMMPPP
PPPAAAAAAAAAAAAAAAAAAAAAAAAAAAABBBTTSSSTTTBSBBBBBBBCCCSSSSSSCAABBBBBBBSSCCBBABSSSSBBBBBBMMMMMMMMMPPP
PPPSSAAAAAABBBBXDXDBBBBBBBBBBBABBBTTTBBBBTTTSTTBBBCBBCSSSSSCSSSAAABBBCCCCSSSSBBBSSSSSSBBBMMMMMMMMPPP
PPPSAAAAAAAATTBCCCCCCCCCCCCCBBABBBTTTBBBBBBBBBTBBCBBBCCSCCCSSBBBBBAAATTACCCCCCCCCCSSSSSSSSMMMMMMMPPP
PPPSAAAAAAAAATBCBBBBCBBBBBCCCBABBBBBBBBBBBBBBBBBCBBBBBBCCSSSBBBBTBBBTTTTAATAAAAAAASSSSSSSBBBMMMMAPPP
PPPSAAAAAAAAATCBBBBBCBBBBCBBCCACCCCCCCXCCBBBBBCCBBBBBBBSSSSBBBSTTBBXCTTTTTATTTTTTAAASSSSBBTBBMMAAPPP
PPPAAAAAAXCCXCBBBBBBCBBBBBBBBBABBBTBBBDCCXCCCCCBCBBBSBBBBSSSBBSBBBBCSCTTTTTTTTTTTTTAAAAAAABBMAAAAPPP
PPPAAAAADCCBBBBBBBBCTTTTSTTSBBABBBTBBBBBBBBCCCBSCBBSXCBBBTBSBBBBBBCCTSCCCCCCSSSTTTTTTTTTTTAAAAAAAPPP
PPPAAAAAACCBBBBBBBCCCCTTSTTCCBABBBTTBBBBBBBCCCMMMCCBBBCBBTBBSBBBBCCTTTSSTTTTSSSTTSTTTSSTTTAAAAAAAPPP
PPPAAAAAAACASTTTTTTTTTTTTTTCXAAXCBBTTTBBSSMXMMMPMMMCCCSSBBSBBBBCCCTTTTSSTTTTSSSTTSTTTSSTTAAAAAAAAPPP
PPPAAAAAAATTTTTTTTTTTTTTTTTCACCDCBBBTTBSSSMPPPPPPPMMMMCCSBBBBBBCTTTTTTTTTTTTCCCCSSCBTTTAAAAAAAAAAPPP
PPPAAAAAATTTTTTTTTTTTTTSSTTCACCACBBTTTBSSMMPPPPPPPPPPMMCCSBBBBTCXTTTTTTAATSTCCTTSCCBBBBAAAAAAAAAAPPP
PPPASAAATTTTTTTSSTTTTTTSSCCCACCACBTTTBBSMMPPPPPPPPPPPPMMCSBBXCCCCTTSSSSSSSSSSCTSSCBBBBBAAAAAAAAAAPPP
PPPASAAATTTTTTTTTTTTTTTTCTBCDXACCBBBBBSSMPPPPPPPPPPPPPPMMCBBBCCDCTTTTTTTTTTCCCTSAXCSBBBDAAAAAAAAAPPP
PPPSAAATTTSTTTTTTSSSTTTTCTTCCCCACBBBBSSMMPPPPPPPPPPPPPPPMCSBBBBBTTTTTTAATTTCCTTSACCDAAAAAAAAAAAAAPPP
PPPAAAASTTTTTTTTTTTTTTSCCBTBBTBTAAASSSMMPPPPPPPPPPPPPPPPMCSBBBBBSBAAABAAATTXDTAAAACAACAAAAAAAAAAAPPP
PPPAAAAABBTTBBTTTTTTTSTTBBTTTTTTTBBSSMMPPPPPPPPPPPPPPPPPMCSBBTTBSBBAAAAAAAAAABBAACCCCCAAAAAAAAAAAPPP
PPPAAAASSBBTBBBTTTTTSTTTTTSTTTTTTTBSMMPPPPPPPPPPPPPPPPPPMMCSBTTBTBBACCCAAAAAABBSAACAACAAAAAAAAAAAPPP
PPPAAASSBBTTTBBTBBTBCTBTTTTBTBTBTTSSMPPPPPPPPPPPPPPPPPPPPMCSBTTBTTBBABCCCCCDXBBBSCCXAAAAAAAAAAAAAPPP
PPPAAASBBTBBBBTBBTBBXTBTBBTBTTTTTTSSMPPPPPPPPPPPPPPPPPPPPMCSBTTTBTBBABBBBBCCCCCCCXAAAAAAAAAAAAAAAPPP
PPPAAASBBTBBSSBSSSSBCTBTTTTBTBTSBTSSMPPPPPPPPPPPPPPPPPPPMMCSBTBTBTBBBABBBBBCCBBBAASSAASSAAAAAAAAAPPP
PPPAASSBBSSBBSTBTCCBCTTBTBTTTBTTBTSSMPPPPPPPPPPPPPPPPPPPMCSSBTTTSTTBBABBBBBCCBAASTSSAASSAAAAAAAAAPPP
PPPAASSBBSSBBSBTBCCSSTTBTTTTTTTTTSSSMMPPPPPPPPPPPPPPPPPPMMCSBTTBBTTTBBAABBBXDAASTTSSASAAAAAATTAAAPPP
PPPAASSBBSSAAASSBCBTTTSTTBTBBTSTTTSSSMMMPPPPPPPPPPPPPPPPPMCSBTTBBTBTBBAAAAAAADXBBBAASSSAAAAATTTAAPPP
PPPAASSDBBSATABBTCBSSSSTTTTTTSTBBTTSSSSMMPPPPPPPPPPPPPPPPMCSBTTBBTTTTBBAXSSSSTBBAABBTTBBAAAAASAAAPPP
PPPAASSBBBSAAABTBCSSBSSSSSSBBSTBCCCCCCDCMMPPPPPPPPPPPPPPPMCSBTBBTTBBTTBBASBTTTBAABBBBTBSBAAAAAAAAPPP
PPPAAASBBBBBBBABSXDAAAAABSSSSAATXDBSSSXCCMMPPPPPPPPPPPPPPMCSBBBTTBBBBTTBBAATXDAABBBTTTTBSSAAAAAAAPPP
PPPAAASSBBTTTBTAAAAACCBBAAAAABBAAAAAASBBCCMMMMPPPPPPPPPPPMCSBTBSSBBTBBTSSSBAAAABBBTTTTTBBSAAAAAAAPPP
PPPAAASSBBBBTBTTTDXCACCBBBBBBBBBDXTTSASSBCCCCMMMMMPPPPPPPMCSBBBBSBSBBBBBBSBTDXBBBTTTTTBBBBAAAAAAAPPP
PPPAAAAASSBBTBTCXCCCBACBBBBBBBBTTCTTTASSSBBCCMMMMMMMMMPPMMCSTTSSSSSSSBBBBSTTTBBBBSSTTBBBBAAAAAAAAPPP
PPPAAAAAASSBBBSCCCCCBACBBBBBBTTTTCTTTSAASSBBCMCCCCMSSMMMMCCSTTTSSTSSSSBBBSBTTSTTTSSBBBBBAAAAAAAAAPPP
PPPAAAAAAASBBBSSSBSSSACCBBTTTTTSSCSSTTTSAAAAAMCXDCMBBASSCSSSSTTSSTTTSSSSSBBBBBTTTTBBBBBSAAAAAAAAAPPP
PPPAAAAAAAASSBSSSBBSSSACBTTTSSTSSCSSSTTTAAAAAMCDXBMBBATTTSSSSTTSSTTTTTSSBBDBBBBTTTBBBSAAAAAAAAAAAPPP
PPPAAAAAAAAAASBBBBBBBBACBTSTSTSSCTCSSTTTTAAAMMSSCSMMAASSTTTTTCCCCCCCCCCXCCCCCXBBTBBBBAAAAAAAAAAAAPPP
PPPAAAAAAAAAASBBBBBSSBACSTCCCCCCTCTCSTTTTTAMMXSSCSSMMAASSTTTTCSSTTTTSSSCCACBBBBBSBBBSAAAAAAAAAAAAPPP
PPPAAAAAAAAAASBBBBBBSBACCSCBDBXTSTSCSSTTTTAMSCCXDCCXMSASSSSSSCSSSSSSSDSSBBBBBBBBBSSSAAAAAAAAAAAAAPPP
PPPAAAAAAAAAAAABBBBBBBBACCXBBBTSTSTCCCCCCCSSSSBDXSSSSSSSSSTTSCSSSSSSTTTSBBBBBSSSAAAAAAAAAAAAAAAAAPPP
PPPAAAAAAAAAAAASBBBBBBSSASTTSTSTSSSXTTTTTBAAMMMSCMMMAAATTTTTSDSSSSTTTTTTBBBBBSAAAAAAAAAAAAAAAAAAAPPP
PPPAAAAAAAAAAASSBBBBBSSSSAASSSBSCCCCTTTBBBBAAAMSCMAAAASSSSSSSTTTSSTSSSSSSSBBAAAAAAAAAAAAAAAAAAAAAPPP
PPPAAAAAAAAAASSCCSBBSSSSSSSASSBBDXDXTTSBBAAAAAMSCMAAABAABBSBSTTTSTTSSSSSSSSSAAAAAAAAAAAAAAAAAAAAAPPP
PPPAAAAAAAAAASTTCBSBSSSSSSSBAAAAAAAAAAAAABBBBAASCXBBBBBCASSXDSSSSTTSSSSSSSSAAAAAAAAAAAAAAAAAAAAAAPPP
PPPAAAAAAAAAASTTCBBSSSSSSSSBBBBBXDXDBBBBBBBBBBCCCCBBBBBCBAAAAASSTTTSSSSSSSSAAAAAAAAAAAAAAAAAAAAAAPPP
PPPAAAAAAAAAASTTCBBASSSSCCCCCCCCCCCBBCCSSBBBBBCBBCBBBBBCBBBDXBAATTTTTSSSSSAAAAAAAAAAAAAAAAAAAAAAAPPP
PPPAAAAAAAAASTTTCCCBSCCCCSSBBBBBTTTBBCBBCBBBBBCBBCBTTTTCBBBBCBBAATTTTSSSSSAAAAAAAAAAAAAAAAAAAAAAAPPP
PPPAAAAAAAASSTTTTSCSSCBABSSBBBBSTTTBBCTTCBBBBBCBBCBTTTTCBBBBCBBBCAAAAAAASSAAAAAAAAAAAAAAAAAAAAAAAPPP
PPPAAAAAAAASSTTSSSCCCCSBSAAABBBSTTTBBCTTSSSCCCCSSSSTTTTCBBBBCBBBCAAABBBSAAAAAAAAAAAAAAAAAAAAAAAAAPPP
PPPAAAAAAAASSSTTSSCBBBBBBSBBABBBSTTBBCTSTSSSBTTDSSXTTBACBBBBAABBCAAAABBSAAAAAAAAAAAAAAAAAAAAAAAAAPPP
PPPAAAAAAAACCCSMMMCBBBBBBSBBAABBTTTBBCBSTTSTSBTTBCCCCBBCBBAACABBCCCCCSAAAAAAAAAAAAAAAAAAAAAAAAAAAPPP
PPPAAAAAAAACMXMMDMCSSSBBBSBBBABBABBBBCSSTTTTSBTTTCTTCBBCBABACBBACBBBXAAAAAAAAAAAAAAAAAAAAAAAAAAAAPPP
PPPAAAAAAAACMMMCCCCSBBBBSBBBBABBBBBBBBBTTTTTBBTTTCTTCBBCBAAACBBBCBBAAAAAAAAAAAAAAAAAAAAAAAAAAAAAAPPP
PPPAAAAAAAACCCCCSCSBBBSSSBBBBAABBBBBBBBTTTBBBBTTTCBBXCCCBBAACCCXCAAAAAAAAAAAAAAAAAAAAAAAAAAAAAAAAPPP
PPPAAAAAAAAAASSSSCCSSSSSAAAAAAAAAAAAABBTTTBBBBTTTCBTAAACCCCCCBBBBAAAAAAAAAAAAAAAAAAAAAAAAAAAAAAAAPPP
PPPAAAAAAAAAAAAAAACCCCSSAAAAAAAAAAAAAABTTBBAATTTTCBBAAAAAAAABBBAAAAAAAAAAAAAAAAAAAAAAAAAAAAAAAAAAPPP
PPPAAAAAAAAAAAAAAAAAAAAAAAAAAAAAAAAAAAAAAAAAATTTTCTTAAAAAAAAAAAAAAAAAAAAAAAAAAAAAAAAAAAAAAAAAAAAAPPP
PPPAAAAAAAAAAAAAAAAAAAAAAAAAAAAAAAAAAAAAAAAAAXCCCDTAAAAAAAAAAAAAAAATTAAAAAAAAAAAAAAAAAAAAAAAAAAAAPPP
PPPAAAAAAAAAAAAAAAAAAAAAAAAAAAAAAAAAAAAAAAAAAAAAABTAAAAAAAAAAAAAAAAAAAAAAAAAAAAAAAAAAAAAAAAAAAAAAPPP
PPPAAAAAAAAAAAAAAAAAAAAAAAAAAAAAAAAAAAAAAAAAAAAAAAAAAAAAAAAAAAAAAAAAAAAAAAAAAAAAAAAAAAAAAAAAAAAAAPPP
PPPAAAAAAAAAAAAAAAAAAAAAAAAAAAAAAAAAAAAAAAAAAAAAAAAAAAAAAAAAAAAAAAAAAAAAAAAAAAAAAAAAAAAAAAAAAAAAAPPP
PPPAAAAAAAAAAAAAAAAAAAAAAAAAAAAAAAAAAAAAAAAAAAAAAAAAAAAAAAAAAAAAAAAAAAAAAAAAAAAAAAAAAAAAAAAAAAAAAPPP
PPPAAAAAAAAAAAAAAAAAAAAAAAAAAAAAAAAAAAAAAAAAAAAAAAAAAAAAAAAAAAAAAAAAAAAAAAAAAAAAAAAAAAAAAAAAAAAAAPPP
PPPPPPPPPPPPPPPPPPPPPPPPPPPPPPPPPPPPPPPPPPPPPPPPPPPPPPPPPPPPPPPPPPPPPPPPPPPPPPPPPPPPPPPPPPPPPPPPPPPP
PPPPPPPPPPPPPPPPPPPPPPPPPPPPPPPPPPPPPPPPPPPPPPPPPPPPPPPPPPPPPPPPPPPPPPPPPPPPPPPPPPPPPPPPPPPPPPPPPPPP
PPPPPPPPPPPPPPPPPPPPPPPPPPPPPPPPPPPPPPPPPPPPPPPPPPPPPPPPPPPPPPPPPPPPPPPPPPPPPPPPPPPPPPPPPPPPPPPPPPPP
0000000000000000000000000000000000000000000000000000000000000000000000000000000000000000000000000000
0000000000000000000000000000000000000000000000000000000000000000000000000000000000000000000000000000
0000000000000000000000000000000000000000000000000000000000000000000000000000000000000000000000000000
0000000000000000000000000000000000000000000000000000000000000000000000000000000000000055555555555000
0000000000000000000000000000000000000000000000000000000000000000000000000000000000000555555555555000
0000000000000000000000000000000000000000000000000000000000000000000000000000000000005555555555555000
0000000000000000000000000000000000000000000000000000000000000000000000000000000000005555555555555000
0000000000000000000000000000000000000000000000000000000000000000000000000000000000005555555555555000
0000000000000000000000000000000000000000000003000000000000000000000000000000000000005555555555555000
0000000000000000000000000000000000000000000011100000000000000000000000000000000000055555555555555000
0000000000000000000000010000000000000000001110110000001111100000000000000000000000555555555555555000
0000000000000000000001111000000000000000111101111022222222111111110000000000000000555555555555555000
0000000000000000000033333333330000000444444111112334444444222211110000000000000005555555555555555000
0000000000000000033333333333333000044444444121123444444444444222111100000000000005555555555555555000
0000000000000000333333333333331000444444444221134444444444444333211100000000000005555555555555555000
0000000000000000333334444403311104444444444222444444444444444444221000000000000005555555555555555000
0000000000000000333334434444444314444444444424444444444444444444442100000000000005555555555555555000
0000000000000333333333333333333333334444444444444444444444444444444210000000000005555555555555555000
0000000000000033333333333333333333334444444444444444444444444444444331000021000005555555555555555000
0000000000000033333333333333333333333444444444444444444444444444444443110000000000555555555555555000
0000000000000011133333333333333333333444444444444444444444444444444444311000000000055555555555555000
0000000000000111110000000000000033333333344444444444444445544444444444111000000000005555555555555000
0000000000001111111111111111111111333333344444444004433345544444444422111000000000005555555555555000
0000000000011111111111111111111111113333324444444444433355555444444222221122222222005555555555555000
0000000000011111111111112211111111111012222232244444444455555444444222222222222222200555555555555000
0000000000011111111111112221111111111112222232244444444555555544444233322222222222222555555555555000
0000000000001111122110012222331111111112222332232444444555555544444233323322222222222555555555555000
0000000000001111122100001002330011111112222333222444444555555544444233223222222222233555555555555000
0000000000001111111100001000110011111111222333222444444555555544444233322222332233335555555555555000
0000000000001111111100001000111111111111222333223344444555555444444231222233322333445555555555555000
0000000000111111111110011001111111110121222333223344444555555444444233222333223333445555555555555000
0000000000011111111111111112111111122221222233223344444455554444442232232232233222225555555555555000
0000000000011111111111111111111131111221222222223344444445544444442222332232222222222555555555555000
0000000000001111111111111111111111111221222222223344444444444444421122322232222222332331155555555000
0000000000000111111111111111000111111112222222224444444444444444421112222222222111344111115555555000
0000001000000111111110000000011111111111111222224444444444444444211111222223322111344111155555555000
0000001100000110111101111111111111111111111112222222444444444442111111112222333313311111155555555000
0000000000000011111111111111111111111111111111222222444444443322111111112222111011111114555555555000
0000000000000111111111111111111111112221111111111112434444443111111111122222211111111114555555555000
0001000000000001111000000000111122222222221111111111134444421111111111111022211111111114455555555000
0001000000000001111111111111111122222222221111111122122422211111111101101122222222201111445555555000
0001000000000001111111111111111122222222211111111222211221111111111011110000000000222211433355550000
0000000000000011111111111111111122222222211111111221211111111111111111111111111110002222333335500000
0000000000111111111111111111111112222221111111111221212211111111110111112233311222100000003350000000
0000000001111111111233334331111112222221113123333122212222111111111111122234313332111112220000000000
0000000001111111111211334331111112222221133443555331111122111111111111121133313430000022220000000000
0000000000104333333333333331033441222221135455505553331112111111001111121111113333110022200000000000
0000000000333333333333333331033441322111335000000055553312211110001111123311122233111110000000000000
0000000003333333333333344331033341331111355000000000055332211100001111122312222231110110000000000000
0000000033333334433333344221033341331113550000000000005532220000002221122314221331111110000000000000
0000000033333333333333332011033441111133500000000000000553220000002321122311111301111111000000000000
0000000133433333344433332123233441111335500000000000000053222111002221003311111301110000000000000000
0000000033333333333333111223311144413355000000000000000053222211110000000011110000100100000000000000
0000000011331133333331311333411122233550000000000000000053232222111000000000000001111100000000000000
0000000001111113333312331234411122235500000000000000000055312222111001000000000000100100000000000000
0000000011111112221112231111221132235000000000000000000005312222211001111111100001110000000000000000
0000000111222122222112231122222132235000000000000000000005313332211100111011111111000000000000000000
0000000111333333333312331222222113335000000000000000000055312232211110011111111100000000000000000000
0000000111444433333311122222224411135000000000000000000053012232211110001111110000000000000000000000
0000000111444433333311133322233411135500000000000000000055312333111111000111100111000000000001000000
0000000111444433222123133333333411133555000000000000000005313113111111000000011100000000000001100000
0000000111444432222223113333333411113335500000000000000005013333221111100011110000133333000000000000
0000000111444432122333111133314411000044550000000000000005312222222111110001110001132223300000000000
0000000111444432222111111111111111000044455000000000000005312222222111220000000011222222310000000000
0000000011444432222111111111111111111044435555000000000005312222122211222110000111222233310000000000
0000000011333332222111112222221111111144433225555500000005311111111111222222111110222231110000000000
0000000001222222222211121111121221222133303225555555550055311444444411122222201112222311100000000000
0000000000012222222221221111122221232111333115444453355553311111111411112222221111111111000000000000
0000000000011221222221121111112221232221111115444453333331114321123411111222221111111110000000000000
0000000000000022221220121111111221233221111115444450000111111111111424111122201111111000000000000000
0000000000000000022200121111111122223122111155333355001111141444444414211122211333111000000000000000
0000000000000000000000121111111122222112111552333325500111141411111114111111111223110000000000000000
0000000000000000000000121111111122212212131522333322510111141424444444111111122203110000000000000000
0000000000000000000000012111111122221221141122333322111111141411111111111111120000000000000000000000
0000000000000000000000111221111122222122241155522555111001141444444411111111000000000000000000000000
0000000000000000000001111112111112222211331111522511101111141211111222231001000000000000000000000000
0000000000000001110011111111222221222113321111522511111111144444444423333000000000000000000000000000
0000000000000011101011111111111111111113211111122111111011111111111123333300000000000000000000000000
0000000000000011100111111111111111111133111111111111111111111111111133333300000000000000000000000000
0000000000000011111111111111111111121333111111110111110011111111111113333000000000000000000000000000
0000000000001111111111111111111111222344311111110111113221111111111113333000000000000000000000000000
0000000000001111011111111111111112222343011111110111113223111111100000000000000000000000000000000000
0000000000001222222211111000111112222333311111111111113203111111100000000000000000000000000000000000
0000000000002222233310122110011111222333301010111111111332221011100000000000000000000000000000000000
0000000000002222233310122111000111222333310102222222211112221011111110000000000000000000000000000000
0000000000002222233411122111000011122333311102222222211122221111100000000000000000000000000000000000
0000000000000222233410122000000011111101111102222222211122221111100000000000000000000000000000000000
0000000000001111222211111000000001111111010002222220411112221111000000000000000000000000000000000000
0000000000000000000001110000000000000111110002222222000111111110000000000000000000000000000000000000
0000000000000000000000000000000000000011100002222222000000000000000000000000000000000000000000000000
0000000000000000000000000000000000000000000002222210000000000000000000000000000000000000000000000000
0000000000000000000000000000000000000000000003222210000000000000000000000000000000000000000000000000
0000000000000000000000000000000000000000000000000000000000000000000000000000000000000000000000000000
0000000000000000000000000000000000000000000000000000000000000000000000000000000000000000000000000000
0000000000000000000000000000000000000000000000000000000000000000000000000000000000000000000000000000
0000000000000000000000000000000000000000000000000000000000000000000000000000000000000000000000000000
0000000000000000000000000000000000000000000000000000000000000000000000000000000000000000000000000000
0000000000000000000000000000000000000000000000000000000000000000000000000000000000000000000000000000
0000000000000000000000000000000000000000000000000000000000000000000000000000000000000000000000000000
0000000000000000000000000000000000000000000000000000000000000000000000000000000000000000000000000000
