100
100
PPPPPPPPPPPPPPPPPPPPPPPPPPPPPPPPPPPPPPPPPPPPPPPPPPPPPPPPPPPPPPPPPPPPPPPPPPPPPPPPPPPPPPPPPPPPPPPPPPPP
PPPPPPPPPPPPPPPPPPPPPPPPPPPPPPPPPPPPPPPPPPPPPPPPPPPPPPPPPPPPPPPPPPPPPPPPPPPPPPPPPPPPPPPPPPPPPPPPPPPP
PPPPPPPPPPPPPPPPPPPPPPPPPPPPPPPPPPPPPPPPPPPPPPPPPPPPPPPPPPPPPPPPPPPPPPPPPPPPPPPPPPPPPPPPPPPPPPPPPPPP
PPPSSCPPPXSSPPPSSSPPPSSSPPPSSSPPPSSSPPPSSSPPPSPPPSSSPPPSSSPPPSSSPPPXSSPPPSSSPPPSSSPPPSSSPPPSSSPXCPPP
PPPSSCCPPPCSSPPPSSSPPPSSSPPPSSSPPPSSSPPPSSSPPPSPPPSSSPPPSSSPPPSSSPPPCSSPPPSSSPPPSSSPPPSSSPPPSSSPCPPP
PPPSCSCCPPPCSSPPPSSSPPPSSSPPPSSSPPPSSSPPPSSSPPPSPPPSSSPPPSSSPPPSSSPPPCSSPPPSSSPPPSSSPPPSSSPPPSSSCPPP
PPPCSSSCCPPPCCSPPPSSSPPPSSSPPPSSSPPPSSSPPPSSSPPPSPPPSSSPPPSSSPPPSSSPPPCSSPPPSSSPPPSSSPPPSSSPPPSSCPPP
PPPSCSSSCCPPPCCSPPPSSSPPPSSSPPPSSSPPPSSSPPPSSSPPPSPPPSSSPPPSSSPPPSSSPPPCSSPPPSSSPPPSSSPPPSSSPPPSCPPP
PPPSSCSSSCCPPPCSSPPPSSSPPPSSSPPPSSSPPPSSSPPPSSSPPPSPPPSSSPPPSSSPPPSSSPPPCSSPPPSSSPPPSSSPPPSSSPPPCPPP
PPPSCSSSSSCCCCCSSSSSSSSSSSSSSSSSSSSSSSSSSSSSSSSSSSSSSSSSSSSSSSSSSSSSSSSCCSSSSSSSSSSSSSSSSSSSSSSSCPPP
PPPCSSSSSSSSCSSSSSSSSSSSSSSSSSSSSSSSSSSSSSSSSSSSSSSSSSSSSSSSSSSSSSSSSSSCSCCSSSSSSSSSSSSSSSSSSSSSCPPP
PPPSCSSSSSSCCSPPPSSSPPPSSSPPPSSSPPPSSSPPPSSSPPPSSSPPPSPPPSSSPPPSSSPPPCCCPPPCSSPPPSSSPPPSSSPPPSSSCPPP
PPPSSCPPPSSCPPPSSSPPPSSSPPPSSSPPPSSSPPPSSSPPPSPPPSSSPPPSSSPPPSSSPPPSSCPPPSSCPPPSSSPPPSSSPPPSSSPCSPPP
PPPSCSSPPPSCCPPPSSSPPPSSSPPPSSSPPPSSSPPPSSSPPPSPPPSSSPPPSSSPPPSSSPPPSCCPPPSSCPPPSSSPPPSSSPPPSSSPCPPP
PPPCSSSSSSSSCCCCCSSSSSSSSSSSSSSSSSSSSSSSSSSSSSSSSSSSSSSSSSSSSSSSCCCCCCCSSSSSSCSSSSSSSSSSSSSSSSSSCPPP
PPPSCSSSSSSSSSSSCCCCSSSSSSSSSSSSSSSSSSSSSSSSSSSSSSSSSSSSSSSSSSSSCSSSSSSSSSSSSSCSSSSSSSSSSSSSSSSCSPPP
PPPSSCSSSSPPPSSSPPPCSSPPPSSSPPPSSSPPPSSSPPPSSSPPPSPPPSSSPPPSSSPPPCSSPPPSSSPPPSSCPPPSSSPPPSSSPPPSCPPP
PPPSCSSSSSSPPPSSSPPPCSSPPPSSSPPPSSSPPPSSSPPPSSSPPPSPPPSSSPPPSSSPPPCSSPPPSSSPPPSCSPPPSSSPPPSSSPPPCPPP
PPPSCSSSSSSSPPPSSSPPPCSSPPPSSSPPPSSSPPPSSSPPPSSSPPPSPPPSSSPPPSSSPPPCSSPPPSSSPPPSCSPPPSSSPPPSSSPCSPPP
PPPCSSSSSSSSSPPPSSSPPPCSSPPPSSSPPPSSSPPPSSSPPPSSSPPPSPPPSSSPPPSSSPPPCSSPPPSSSPPPSCSPPPSSSPPPSSSPCPPP
PPPSCSSSSSSSSSPPPSSSPPPCSSPPPSSSPPPSSSPPPSSSPPPSSSPPPSPPPSSSPPPSSSPPPCSSPPPSSSPPPCSSPPPSSSPPPSCCCPPP
PPPSCSPPPSSSPPPSSSPPPSSCPPPSSSPPPSSSPPPSSSPPPSPPPSSSPPPSSSPPPSSSPPPSSCPPPSSSPPPSSCPPPSSSPPPSSCPSSPPP
PPPSSCSPPPSSSPPPSSSPPPSSCPPPSSSPPPSSSPPPSSSPPPSPPPSSSPPPSSSPPPSSSPPPSSCPPPSSSPPPSSCPPPSSSPPPSSCPSPPP
PPPSCSSSPPPSSSPPPSSSPPPSSCPPPSSSPPPSSSPPPSSSPPPSPPPSSSPPPSSSPPPSSSPPPSCSPPPSSSPPPSSCPPPSSSPPPSCSSPPP
PPPSCSSSSPPPSSSPPPSSSPPPCSCPPPSSSPPPSSSPPPSSSPPPSPPPSSSPPPSSSPPPCCCPPPCSSPPPSSSPPPSSCPPPSSSPPPCSSPPP
PPPCSSSSSSSSSSSSSSSSSSSCSSSCCCSSSSSSSSSSSSSSSSSSSSSSSSSSSSSSSSSSCSCCCCCSSSSSSSSSSSSSSCCCCCCCCCCSSPPP
PPPSCSSSSSSSSSSSSSSSSSCSSSSSSCCCCCSSSSSSSSSSSSSSSSSSSSSSSSSSSSSCSSSSSSSSSSSSSSSSSSSSSSSSSSSSSSSCSPPP
PPPSCSSSSSSSPPPSSSPPPCSSPPPSSCPPPCSSPPPSSSPPPSSSPPPSPPPSSSPPPSCSPPPSSSPPPSSSPPPSSSPPPSSSPPPSSSPSCPPP
PPPSSCSSSSSSSPPPSSSPPPCSSPPPSCSPPPCSSPPPSSSPPPSSSPPPSPPPSSSPPPCCSPPPSSSPPPSSSPPPSSSPPPSSSPPPSSSPCPPP
PPPSCSSSSSSSSSPPPSSSPPPCSSPPPCSSPPPCSSPPPSSSPPPSSSPPPSPPPSSSPPPSCSPPPSSSPPPSSSPPPSSSPPPSSSPPPSSSCPPP
PPPSCSPPPSSSPPPSSSPPPSSCPPPSSCPPPSSCPPPSSSPPPSPPPSSSPPPSSSPPPSSCPPPSSSPPPSSSPPPSSSPPPSSSPPPSSSPSCPPP
PPPCSSSPPPSSSPPPSSSPPPSCSPPPSCSPPPSCCPPPSSSPPPSPPPSSSPPPSSSPPPCSSPPPSSSPPPSSSPPPSSSPPPSSSPPPSSSPCPPP
PPPCSSSSPPPSSSPPPSSSPPPCSSPPPCCCPPPSSCPPPSSSPPPSPPPSSSPPPSSSPPPCSSPPPSSSPPPSSSPPPSSSPPPSSSPPPSSSCPPP
PPPSCSSSSPPPSSSPPPSSSPPPCSSPPPSSCPPPSSCPPPSSSPPPSPPPSSSPPPSSSPPPCSSPPPSSSPPPSSSPPPSSSPPPSSSPPPSSCPPP
PPPSCSSSSSSSSSSSSSSSSSSSSCSSSSSSSCSSSSSCSSSSSSSSSSSSSSSSSSSSSSSCCSSSSSSSSSSSSSSSSSSSSSSSSSSSSSSSCPPP
PPPSCSSSSSSSSSSSSSSSSSSSSSCSSSSSSSCSSSSSCCCCCCSSSSSSSSSSSSSSSSSCSSSSSSSSSSSSSSSSSSSSSSSSSSSSSSSSCPPP
PPPSCSSSSSSSPPPSSSPPPSSSPPPCSSPPPSSCPPPSSSPPPCSSPPPSPPPSSSPPPSSCPPPSSSPPPSSSPPPSSSPPPSSSPPPSSSPSCPPP
PPPSSCSSSSSSSPPPSSSPPPSSSPPPCCSPPPSCSPPPSSSPPPCSSPPPSPPPSSSPPPSCSPPPSSSPPPSSSPPPSSSPPPSSSPPPSSSPCPPP
PPPSSCSSSSSSSSPPPSSSPPPSSSPPPCSSPPPCSSPPPSSSPPPCCSPPPSPPPSSSPPPCSSPPPSSSPPPSSSPPPSSSPPPSSSPPPSSSCPPP
PPPSCSPPPSSSPPPSSSPPPSSSPPPSSCPPPSSCPPPSSSPPPSPPPCSSPPPSSSPPPSSCPPPSSSPPPSSSPPPSSSPPPSSSPPPSSSPSCPPP
PPPSCSSPPPSSSPPPSSSPPPSSSPPPSCSPPPSCSPPPSSSPPPSPPPCSSPPPSSSPPPSSCPPPSSSPPPSSSPPPSSSPPPSSSPPPSSSPCPPP
PPPSCSSSPPPSSSPPPSSSPPPSSSPPPCSSPPPCSSPPPSSSPPPSPPPCSSPPPSSSPPPSCSPPPSSSPPPSSSPPPSSSPPPSSSPPPSSCCPPP
PPPSCSSSSPPPSSSPPPSSSPPPSSSPPPCSSPPPCSSPPPSSSPPPSPPPCSSPPPSSSPPPCSSPPPSSSPPPSSSPPPSSSPPPSSSPPPSCSPPP
PPPCSSSSSSSSSSSSSSSSSSSSSSSSSCSSSSSSSCSSSSSSSSSSSSSSSCSSSSSSSSSSCSSSSSSSSSSSSSSSSSSSSSSSSSSSSSCSSPPP
PPPCSSSSSSSSSSSSSSSSSSSSSSSSCSSSSSSSCSCSSSSSSSSSSSSSSSCSSSCCCCCCCCCCSSSSSSSSSSSSSSSSSSSSSSSSSSSCSPPP
PPPSCSSSSSSSPPPSSSPPPSSSPPPCSSPPPSCCPPPCSSPPPSSSPPPSPPPCXCPPPSSSPPPCCSPPPSSSPPPSSSPPPSSSPPPSSSPSCPPP
PPPSCSSSSSSSSPPPSSSPPPSSSPPPCSSPPPCSSPPPCCSPPPSSSPPPSPPPCCSPPPSSSPPPCCSPPPSSSPPPSSSPPPSSSPPPSSSPCPPP
PPPSCSSSSSSSSSPPPSSSPPPSSSPPPCSSPPPCSSPPPCSSPPPSSSPPPSPPPSSSPPPSSSPPPCSSPPPSSSPPPSSSPPPSSSPPPSSSCPPP
PPPSCSPPPSSSPPPSSSPPPSSSPPPSSCPPPSSCPPPSSCPPPSPPPSSSPPPSSCPPPSSSPPPSSCPPPSSSPPPSSSPPPSSSPPPSSSPSCPPP
PPPSSCSPPPSSSPPPSSSPPPSSSPPPSCSPPPSCSPPPSCSPPPSPPPSSSPPPSCSPPPSSSPPPSCSPPPSSSPPPSSSPPPSSSPPPSSSPCPPP
PPPSSCSSPPPSSSPPPSSSPPPSSSPPPCSSPPPCSSPPPCSSPPPSPPPSSSPPPCSSPPPSSSPPPCCSPPPSSSPPPSSSPPPSSSPPPSSSCPPP
PPPSCSSSSPPPSSSPPPSSSPPPSSSPPPCSSPPPCSSPPPCSSPPPSPPPSSSPPPCSSPPPSSSPPPCSSPPPSSSPPPSSSPPPSSSPPPSSCPPP
PPPSCSSSSSSSSSSSSSSSSSSSSSSSSCCSSSSSSCSSSSSCSSSSSSSSSSSSSCSSSSSSSSSSSSCCSSSSSSSSSSSSSSSSSSSSSSSSCPPP
PPPSCSSSSSSSSSSSSSSSSSSSSSSSCSSSSSSSSSCSSSSSCSSSSSSSSSSSSCSSSSSSSSSSSSSCCSSSSSSSSSSSSSSSSSSSSSSSCPPP
PPPSCSSSSSSSPPPSSSPPPSSSPPPXSSPPPSSSPPPCSSPPPCSSPPPSPPPSSCPPPSSSPPPSSSPPCCSSPPPSSSPPPSSSPPPSSSPSCPPP
PPPCSSSSSSSSSPPPSSSPPPSSSPPPCSSPPPSSSPPPCSSPPPCSSPPPSPPPSCSPPPSSSPPPSSSPPPCSSPPPSSSPPPSSSPPPSSSPCPPP
PPPCSSSSSSSSSSPPPSSSPPPSSSPPPCSSPPPSSSPPPCSSPPPCCSPPPSPPPCSSPPPSSSPPPSSSPPPCSSPPPSSSPPPSSSPPPSSSCPPP
PPPSCSPPPSSSPPPSSSPPPSSSPPPSSCPPPSSSPPPSSCPPPSPPPCSSPPPSSCPPPSSSPPPSSSPPPSSCPPPSSSPPPSSSPPPSSSPSCPPP
PPPSCSSPPPSSSPPPSSSPPPSSSPPPSCSPPPSSSPPPSCSPPPSPPPCSSPPPSSCPPPSSSPPPSSSPPPSCSPPPSSSPPPSSSPPPSSSPCPPP
PPPSCSSSPPPSSSPPPSSSPPPSSSPPPCCSPPPSSSPPPCSSPPPSPPPCCSPPPSCSPPPSSSPPPSSSPPPCSSPPPSSSPPPSSSPPPSSSCPPP
PPPSCSSSSPPPSSSPPPSSSPPPSSSPPPCSSPPPSSSPPPCSSPPPSPPPCSSPPPCSSPPPSSSPPPSSSPPPCSSPPPSSSPPPSSSPPPSCSPPP
PPPSSCSSSSSSSSSSSSSSSSSSSSSSSCCSSSSSSSSSSSCSSSSSSSSSCSSCCCCSSSSSSSSSSSSSSSSSSCSSSSSSSSSSSSSSSSCSSPPP
PPPCCCSSSSSCCCCCCCCCCCCCCCCCCCSSSSSSSSSSSSCSSSSSSSSSXCCSSSSSSSSSSSSSSSSSSSSSSSCSSSSSSSSSSSSSSSSCSPPP
PPPCSSSSSSSCPPPSSSPPPSSCPCPCSSPPPSSSPPPSSCPPPSSSPPPSPPPSSSPPPSSSPPPSSSPPPSSSPPPCSSPPPSSSPPPSSSPSCPPP
PPPCCCXCCCSCSPPPSSSPPPSCSPPPSSSPPPSSSPPPCSSPPPSSSPPPSPPPSSSPPPSSSPPPSSSPPPSSSPPPCCSPPPSSSPPPSSSPCPPP
PPPSSSSSSSCSSSPPPSSSPPPCSSPPPSSSPPPSSSPPPCSSPPPSSSPPPSPPPSSSPPPSSSPPPSSSPPPSSSPPPCSSPPPSSSPPPSSSCPPP
PPPSSSPPPSSSPPPSSSPPPSSCPPPSSSPPPSSSPPPSSCPPPSPPPSSSPPPSSSPPPSSSPPPSSSPPPSSSPPPSSCPPPSSSPPPSSSPSCPPP
PPPSSSSPPPSSSPPPSSSPPPSCSPPPSSSPPPSSSPPPSCSPPPSPPPSSSPPPSSSPPPSSSPPPSSSPPPSSSPPPSCSPPPSSSPPPSSSPCPPP
PPPSSSSSPPPSSSPPPSSSPPPCSSPPPSSSPPPSSSPPPCSSPPPSPPPSSSPPPSSSPPPSSSPPPSSSPPPSSSPPPCSSPPPSSSPPPSSSCPPP
PPPSSSSSSPPPSSSPPPSSSPPPCSSPPPSSSPPPSSSPPPCSSPPPSPPPSSSPPPSSSPPPSSSPPPSSSPPPSSSPPPCSSPPPSSSPPPSSCPPP
PPPSSSSSSSPPPSSSPPPSSSPPPCSSPPPSSSPPPSSSPPPCSSPPPSPPPSSSPPPSSSPPPSSSPPPSSSPPPSSSPPPCSSPPPSSSPPPSCPPP
PPPSSSSSSSSPPPSSSPPPSSSPPPCSSPPPSSSPPPSSSPPPCSSPPPSPPPSSSPPPSSSPPPSSSPPPSSSPPPSSSPPPCSSPPPSSSPPPCPPP
PPPSSSSSSSSSSSSSSSSSSSSSSSSCSSSSSSSSSSSSSSSSCCSSSSSSSSSSSSSSSSSSSSSSSSSSSSSSSSSSSSSSSCSSSSSSSSSSCPPP
PPPSSSSSSSSSSSSSSSSSSSSSSSSSCCSSSSSSSSSSSSSSSCCCSSSSSSSSSSSSSSSSSSSSSSSSSSSSSSSSSSSSSSCSSSSSSSSSCPPP
PPPSSSSSSSSSSSPPPSSSPPPSSSPPPCSSPPPSSSPPPSSSPPPCCCPPPSPPPSSSPPPSSSPPPSSSPPPSSSPPPSSSPPPCSSPPPSSSCPPP
PPPSSSPPPSSSPPPSSSPPPSSSPPPSSCPPPSSSPPPSSSPPPSPPPCCSPPPSSSPPPSSSPPPSSSPPPSSSPPPSSSPPPSSCPPPSSSPSCPPP
PPPSSSSPPPSSSPPPSSSPPPSSSPPPSCSPPPSSSPPPSSSPPPSPPPCSSPPPSSSPPPSSSPPPSSSPPPSSSPPPSSSPPPSCSPPPSSSPCPPP
PPPSSSSSPPPSSSPPPSSSPPPSSSPPPCSSPPPSSSPPPSSSPPPSPPCCSSPPPSSSPPPSSSPPPSSSPPPSSSPPPSSSPPPCCCPPPSSSCPPP
PPPSSSSSSSSSSSSSSSSSSSSSSSSSSCCCSSSSSSSSSSSSSSSCCCCSSSSSSSSSSSSSSSSSSSSSSSSSSSSSSSSSSSSCXCCCCCCCCPPP
PPPSSSSSSSSPPPSSSPPPSSSPPPSSSPPPCSSPPPSSSPPPSSCCPPSPPPSSSPPPSSSPPPSSSPPPSSSPPPSSSPPPSSSPPPSSSPPPCPPP
PPPSSSSSSSSSPPPSSSPPPSSSPPPSSSPPPCSSPPPSSSPPPXSSPPPSPPPSSSPPPSSSPPPSSSPPPSSSPPPSSSPPPSSSPPPSSSPSCPPP
PPPSSSSSSSSSSPPPSSSPPPSSSPPPSSSPPPCCSPPPSSSPPPCSSPPPSPPPSSSPPPSSSPPPSSSPPPSSSPPPSSSPPPSSSPPPSSSPCPPP
PPPSSSSSSSSSSSPPPSSSPPPSSSPPPSSSPPPCSSPPPSSSPPPCCSPPPSPPPSSSPPPSSSPPPSSSPPPSSSPPPSSSPPPSSSPPPSSSCPPP
PPPSSSPPPSSSPPPSSSPPPSSSPPPSSSPPPSSCPPPSSSPPPSPPPCSSPPPSSSPPPSSSPPPSSSPPPSSSPPPSSSPPPSSSPPPSSSPSCPPP
PPPSSSSPPPSSSPPPSSSPPPSSSPPPSSSPPPSCSPPPSSSPPPSPPPCSSPPPSSSPPPSSSPPPSSSPPPSSSPPPSSSPPPSSSPPPSSSPCPPP
PPPSSSSSPPPSSSPPPSSSPPPSSSPPPSSSPPPCCSPPPSSSPPPSPPPCSSPPPSSSPPPSSSPPPSSSPPPSSSPPPSSSPPPSSSPPPSSSCPPP
PPPSSSSSSPPPSSSPPPSSSPPPSSSPPPSSSPPPCSSPPPSSSPPPSPPPCSSPPPSSSPPPSSSPPPSSSPPPSSSPPPSSSPPPSSSPPPSCSPPP
PPPSSSSSSSSSSSSSSSSSSSSSSSSSSSCCCCCCCSSSSSSSSCCCCCCCCSSCSCSCSCCCSSCCSSCCSSCCCSSSCCCSSSCCCSSSCCCSSPPP
PPPSSSSSSSSSSSSSSSSSSSSSSSSSSCSSSSSSSCCCCCCCCCSSSSSSSCCSCSCSCCSCCCSSCCSSCCSSSCCCSSSCCCSSSCCCSSSCCPPP
PPPSSSSSSSSSPPPSSSPPPSSSPPPXCSPPPSSSPPPSSSPPPCCSPPPSPPPSSSPPPSSSPPPSSSPPPSSSPPPSSSPPPSSSPPPSSSPSCPPP
PPPSSSSSSSSSSPPPSSSPPPSSSPPPSSSPPPSSSPPPSSSPPPCCSPPPSPPPSSSPPPSSSPPPSSSPPPSSSPPPSSSPPPSSSPPPSSSPCPPP
PPPSSSSSSSSSSSPPPSSSPPPSSSPPPSSSPPPSSSPPPSSSPPPCCCPPPSPPPSSSPPPSSSPPPSSSPPPSSSPPPSSSPPPSSSPPPSSSCPPP
PPPSSSPPPSSSPPPSSSPPPSSSPPPSSSPPPSSSPPPSSSPPPSPPPCCSPPPSSSPPPSSSPPPSSSPPPSSSPPPSSSPPPSSSPPPSSSPSCPPP
PPPSSSSPPPSSSPPPSSSPPPSSSPPPSSSPPPSSSPPPSSSPPPSPPPCCSPPPSSSPPPSSSPPPSSSPPPSSSPPPSSSPPPSSSPPPSSSPCPPP
PPPSSSSSPPPSSSPPPSSSPPPSSSPPPSSSPPPSSSPPPSSSPPPSPPPCCSPPPSSSPPPSSSPPPSSSPPPSSSPPPSSSPPPSSSPPPSSSCPPP
PPPSSSSSSPPPSSSPPPSSSPPPSSSPPPSSSPPPSSSPPPSSSPPPSPPPCSSPPPSSSPPPSSSPPPSSSPPPSSSPPPSSSPPPSSSPPPSSCPPP
PPPSSSSSSSSSSSSSSSSSSSSSSSSSSSSSSSSSSSSSSSSSSSSSSSSSSSSSSSSSSSSSSSSSSSSSSSSSSSSSSSSSSSSSSSSSSSSSXPPP
PPPPPPPPPPPPPPPPPPPPPPPPPPPPPPPPPPPPPPPPPPPPPPPPPPPPPPPPPPPPPPPPPPPPPPPPPPPPPPPPPPPPPPPPPPPPPPPPPPPP
PPPPPPPPPPPPPPPPPPPPPPPPPPPPPPPPPPPPPPPPPPPPPPPPPPPPPPPPPPPPPPPPPPPPPPPPPPPPPPPPPPPPPPPPPPPPPPPPPPPP
PPPPPPPPPPPPPPPPPPPPPPPPPPPPPPPPPPPPPPPPPPPPPPPPPPPPPPPPPPPPPPPPPPPPPPPPPPPPPPPPPPPPPPPPPPPPPPPPPPPP
0000000000000000000000000000000000000000000000000000000000000000000000000000000000000000000000000000
0000000000000000000000000000000000000000000000000000000000000000000000000000000000000000000000000000
0000000000000000000000000000000000000000000000000000000000000000000000000000000000000000000000000000
0000000000000000000000000000000000000000000000000000000000000000000000000000000000000000000000000000
0000000000000000000000000000000000000000000000000000000000000000000000000000000000000000000000000000
0000000000000000000000000000000000000000000000000000000000000000000000000000000000000000000000000000
0000000000000000000000000000000000000000000000000000000000000000000000000000000000000000000000000000
0000000000000000000000000000000000000000000000000000000000000000000000000000000000000000000000000000
0000000000000000000000000000000000000000000000000000000000000000000000000000000000000000000000000000
0000000000000000000000000000000000000000000000000000000000000000000000000000000000000000000000000000
0000000000000000000000000000000000000000000000000000000000000000000000000000000000000000000000000000
0000000000000000000000000000000000000000000000000000000000000000000000000000000000000000000000000000
0000000000000000000000000000000000000000000000000000000000000000000000000000000000000000000000000000
0000000000000000000000000000000000000000000000000000000000000000000000000000000000000000000000000000
0000000000000000000000000000000000000000000000000000000000000000000000000000000000000000000000000000
0000000000000000000000000000000000000000000000000000000000000000000000000000000000000000000000000000
0000000000000000000000000000000000000000000000000000000000000000000000000000000000000000000000000000
0000000000000000000000000000000000000000000000000000000000000000000000000000000000000000000000000000
0000000000000000000000000000000000000000000000000000000000000000000000000000000000000000000000000000
0000000000000000000000000000000000000000000000000000000000000000000000000000000000000000000000000000
0000000000000000000000000000000000000000000000000000000000000000000000000000000000000000000000000000
0000000000000000000000000000000000000000000000000000000000000000000000000000000000000000000000000000
0000000000000000000000000000000000000000000000000000000000000000000000000000000000000000000000000000
0000000000000000000000000000000000000000000000000000000000000000000000000000000000000000000000000000
0000000000000000000000000000000000000000000000000000000000000000000000000000000000000000000000000000
0000000000000000000000000000000000000000000000000000000000000000000000000000000000000000000000000000
0000000000000000000000000000000000000000000000000000000000000000000000000000000000000000000000000000
0000000000000000000000000000000000000000000000000000000000000000000000000000000000000000000000000000
0000000000000000000000000000000000000000000000000000000000000000000000000000000000000000000000000000
0000000000000000000000000000000000000000000000000000000000000000000000000000000000000000000000000000
0000000000000000000000000000000000000000000000000000000000000000000000000000000000000000000000000000
0000000000000000000000000000000000000000000000000000000000000000000000000000000000000000000000000000
0000000000000000000000000000000000000000000000000000000000000000000000000000000000000000000000000000
0000000000000000000000000000000000000000000000000000000000000000000000000000000000000000000000000000
0000000000000000000000000000000000000000000000000000000000000000000000000000000000000000000000000000
0000000000000000000000000000000000000000000000000000000000000000000000000000000000000000000000000000
0000000000000000000000000000000000000000000000000000000000000000000000000000000000000000000000000000
0000000000000000000000000000000000000000000000000000000000000000000000000000000000000000000000000000
0000000000000000000000000000000000000000000000000000000000000000000000000000000000000000000000000000
0000000000000000000000000000000000000000000000000000000000000000000000000000000000000000000000000000
0000000000000000000000000000000000000000000000000000000000000000000000000000000000000000000000000000
0000000000000000000000000000000000000000000000000000000000000000000000000000000000000000000000000000
0000000000000000000000000000000000000000000000000000000000000000000000000000000000000000000000000000
0000000000000000000000000000000000000000000000000000000000000000000000000000000000000000000000000000
0000000000000000000000000000000000000000000000000000000000000000000000000000000000000000000000000000
0000000000000000000000000000000000000000000000000000000000000000000000000000000000000000000000000000
0000000000000000000000000000000000000000000000000000000000000000000000000000000000000000000000000000
0000000000000000000000000000000000000000000000000000000000000000000000000000000000000000000000000000
0000000000000000000000000000000000000000000000000000000000000000000000000000000000000000000000000000
0000000000000000000000000000000000000000000000000000000000000000000000000000000000000000000000000000
0000000000000000000000000000000000000000000000000000000000000000000000000000000000000000000000000000
0000000000000000000000000000000000000000000000000000000000000000000000000000000000000000000000000000
0000000000000000000000000000000000000000000000000000000000000000000000000000000000000000000000000000
0000000000000000000000000000000000000000000000000000000000000000000000000000000000000000000000000000
0000000000000000000000000000000000000000000000000000000000000000000000000000000000000000000000000000
0000000000000000000000000000000000000000000000000000000000000000000000000000000000000000000000000000
0000000000000000000000000000000000000000000000000000000000000000000000000000000000000000000000000000
0000000000000000000000000000000000000000000000000000000000000000000000000000000000000000000000000000
0000000000000000000000000000000000000000000000000000000000000000000000000000000000000000000000000000
0000000000000000000000000000000000000000000000000000000000000000000000000000000000000000000000000000
0000000000000000000000000000000000000000000000000000000000000000000000000000000000000000000000000000
0000000000000000000000000000000000000000000000000000000000000000000000000000000000000000000000000000
0000000000000000000000000000000000000000000000000000000000000000000000000000000000000000000000000000
0000000000000000000000000000000000000000000000000000000000000000000000000000000000000000000000000000
0000000000000000000000000000000000000000000000000000000000000000000000000000000000000000000000000000
0000000000000000000000000000000000000000000000000000000000000000000000000000000000000000000000000000
0000000000000000000000000000000000000000000000000000000000000000000000000000000000000000000000000000
0000000000000000000000000000000000000000000000000000000000000000000000000000000000000000000000000000
0000000000000000000000000000000000000000000000000000000000000000000000000000000000000000000000000000
0000000000000000000000000000000000000000000000000000000000000000000000000000000000000000000000000000
0000000000000000000000000000000000000000000000000000000000000000000000000000000000000000000000000000
0000000000000000000000000000000000000000000000000000000000000000000000000000000000000000000000000000
0000000000000000000000000000000000000000000000000000000000000000000000000000000000000000000000000000
0000000000000000000000000000000000000000000000000000000000000000000000000000000000000000000000000000
0000000000000000000000000000000000000000000000000000000000000000000000000000000000000000000000000000
0000000000000000000000000000000000000000000000000000000000000000000000000000000000000000000000000000
0000000000000000000000000000000000000000000000000000000000000000000000000000000000000000000000000000
0000000000000000000000000000000000000000000000000000000000000000000000000000000000000000000000000000
0000000000000000000000000000000000000000000000000000000000000000000000000000000000000000000000000000
0000000000000000000000000000000000000000000000000000000000000000000000000000000000000000000000000000
0000000000000000000000000000000000000000000000000000000000000000000000000000000000000000000000000000
0000000000000000000000000000000000000000000000000000000000000000000000000000000000000000000000000000
0000000000000000000000000000000000000000000000000000000000000000000000000000000000000000000000000000
0000000000000000000000000000000000000000000000000000000000000000000000000000000000000000000000000000
0000000000000000000000000000000000000000000000000000000000000000000000000000000000000000000000000000
0000000000000000000000000000000000000000000000000000000000000000000000000000000000000000000000000000
0000000000000000000000000000000000000000000000000000000000000000000000000000000000000000000000000000
0000000000000000000000000000000000000000000000000000000000000000000000000000000000000000000000000000
0000000000000000000000000000000000000000000000000000000000000000000000000000000000000000000000000000
0000000000000000000000000000000000000000000000000000000000000000000000000000000000000000000000000000
0000000000000000000000000000000000000000000000000000000000000000000000000000000000000000000000000000
0000000000000000000000000000000000000000000000000000000000000000000000000000000000000000000000000000
0000000000000000000000000000000000000000000000000000000000000000000000000000000000000000000000000000
0000000000000000000000000000000000000000000000000000000000000000000000000000000000000000000000000000
0000000000000000000000000000000000000000000000000000000000000000000000000000000000000000000000000000
0000000000000000000000000000000000000000000000000000000000000000000000000000000000000000000000000000
0000000000000000000000000000000000000000000000000000000000000000000000000000000000000000000000000000
0000000000000000000000000000000000000000000000000000000000000000000000000000000000000000000000000000
0000000000000000000000000000000000000000000000000000000000000000000000000000000000000000000000000000
0000000000000000000000000000000000000000000000000000000000000000000000000000000000000000000000000000
